"filename", "language", "HTML", "CSS", "TypeScript", "JavaScript", "comment", "blank", "total"
"c:\Users\Fire and Ice\Documents\GitHub\frontend2\src\app\Admin\c\change-password\change-password.component.css", "CSS", 0, 0, 0, 0, 0, 1, 1
"c:\Users\Fire and Ice\Documents\GitHub\frontend2\src\app\Admin\c\change-password\change-password.component.html", "HTML", 137, 0, 0, 0, 0, 10, 147
"c:\Users\Fire and Ice\Documents\GitHub\frontend2\src\app\Admin\c\change-password\change-password.component.spec.ts", "TypeScript", 0, 0, 18, 0, 0, 6, 24
"c:\Users\Fire and Ice\Documents\GitHub\frontend2\src\app\Admin\c\change-password\change-password.component.ts", "TypeScript", 0, 0, 302, 0, 4, 8, 314
"c:\Users\Fire and Ice\Documents\GitHub\frontend2\src\app\Admin\c\functionalities\functionalities.component.css", "CSS", 0, 0, 0, 0, 0, 1, 1
"c:\Users\Fire and Ice\Documents\GitHub\frontend2\src\app\Admin\c\functionalities\functionalities.component.html", "HTML", 26, 0, 0, 0, 1, 2, 29
"c:\Users\Fire and Ice\Documents\GitHub\frontend2\src\app\Admin\c\functionalities\functionalities.component.spec.ts", "TypeScript", 0, 0, 18, 0, 0, 6, 24
"c:\Users\Fire and Ice\Documents\GitHub\frontend2\src\app\Admin\c\functionalities\functionalities.component.ts", "TypeScript", 0, 0, 374, 0, 4, 11, 389
"c:\Users\Fire and Ice\Documents\GitHub\frontend2\src\app\Admin\c\functionalities_role_based\functionalities_role.component.css", "CSS", 0, 0, 0, 0, 0, 1, 1
"c:\Users\Fire and Ice\Documents\GitHub\frontend2\src\app\Admin\c\functionalities_role_based\functionalities_role.component.html", "HTML", 26, 0, 0, 0, 0, 1, 27
"c:\Users\Fire and Ice\Documents\GitHub\frontend2\src\app\Admin\c\functionalities_role_based\functionalities_role.component.spec.ts", "TypeScript", 0, 0, 18, 0, 0, 6, 24
"c:\Users\Fire and Ice\Documents\GitHub\frontend2\src\app\Admin\c\functionalities_role_based\functionalities_role.component.ts", "TypeScript", 0, 0, 386, 0, 66, 11, 463
"c:\Users\Fire and Ice\Documents\GitHub\frontend2\src\app\Admin\c\logins\logins.component.css", "CSS", 0, 0, 0, 0, 0, 1, 1
"c:\Users\Fire and Ice\Documents\GitHub\frontend2\src\app\Admin\c\logins\logins.component.html", "HTML", 50, 0, 0, 0, 0, 2, 52
"c:\Users\Fire and Ice\Documents\GitHub\frontend2\src\app\Admin\c\logins\logins.component.spec.ts", "TypeScript", 0, 0, 18, 0, 0, 6, 24
"c:\Users\Fire and Ice\Documents\GitHub\frontend2\src\app\Admin\c\logins\logins.component.ts", "TypeScript", 0, 0, 342, 0, 147, 12, 501
"c:\Users\Fire and Ice\Documents\GitHub\frontend2\src\app\Admin\c\mm\mm.component.css", "CSS", 0, 0, 0, 0, 0, 1, 1
"c:\Users\Fire and Ice\Documents\GitHub\frontend2\src\app\Admin\c\mm\mm.component.html", "HTML", 49, 0, 0, 0, 0, 1, 50
"c:\Users\Fire and Ice\Documents\GitHub\frontend2\src\app\Admin\c\mm\mm.component.spec.ts", "TypeScript", 0, 0, 18, 0, 0, 6, 24
"c:\Users\Fire and Ice\Documents\GitHub\frontend2\src\app\Admin\c\mm\mm.component.ts", "TypeScript", 0, 0, 211, 0, 127, 12, 350
"c:\Users\Fire and Ice\Documents\GitHub\frontend2\src\app\Admin\c\register-actor\multi-dropdown-role\multi-dropdown-role.component.css", "CSS", 0, 0, 0, 0, 0, 1, 1
"c:\Users\Fire and Ice\Documents\GitHub\frontend2\src\app\Admin\c\register-actor\multi-dropdown-role\multi-dropdown-role.component.html", "HTML", 3, 0, 0, 0, 0, 0, 3
"c:\Users\Fire and Ice\Documents\GitHub\frontend2\src\app\Admin\c\register-actor\multi-dropdown-role\multi-dropdown-role.component.spec.ts", "TypeScript", 0, 0, 18, 0, 0, 6, 24
"c:\Users\Fire and Ice\Documents\GitHub\frontend2\src\app\Admin\c\register-actor\multi-dropdown-role\multi-dropdown-role.component.ts", "TypeScript", 0, 0, 163, 0, 14, 10, 187
"c:\Users\Fire and Ice\Documents\GitHub\frontend2\src\app\Admin\c\register-actor\register-actor.component.css", "CSS", 0, 0, 0, 0, 0, 1, 1
"c:\Users\Fire and Ice\Documents\GitHub\frontend2\src\app\Admin\c\register-actor\register-actor.component.html", "HTML", 194, 0, 0, 0, 24, 2, 220
"c:\Users\Fire and Ice\Documents\GitHub\frontend2\src\app\Admin\c\register-actor\register-actor.component.spec.ts", "TypeScript", 0, 0, 18, 0, 0, 6, 24
"c:\Users\Fire and Ice\Documents\GitHub\frontend2\src\app\Admin\c\register-actor\register-actor.component.ts", "TypeScript", 0, 0, 604, 0, 156, 17, 777
"c:\Users\Fire and Ice\Documents\GitHub\frontend2\src\app\Admin\c\roles\roles.component.css", "CSS", 0, 0, 0, 0, 0, 1, 1
"c:\Users\Fire and Ice\Documents\GitHub\frontend2\src\app\Admin\c\roles\roles.component.html", "HTML", 34, 0, 0, 0, 0, 1, 35
"c:\Users\Fire and Ice\Documents\GitHub\frontend2\src\app\Admin\c\roles\roles.component.spec.ts", "TypeScript", 0, 0, 18, 0, 0, 6, 24
"c:\Users\Fire and Ice\Documents\GitHub\frontend2\src\app\Admin\c\roles\roles.component.ts", "TypeScript", 0, 0, 643, 0, 294, 21, 958
"c:\Users\Fire and Ice\Documents\GitHub\frontend2\src\app\Admin\c\user-activities\user-activities.component.css", "CSS", 0, 0, 0, 0, 0, 1, 1
"c:\Users\Fire and Ice\Documents\GitHub\frontend2\src\app\Admin\c\user-activities\user-activities.component.html", "HTML", 48, 0, 0, 0, 13, 2, 63
"c:\Users\Fire and Ice\Documents\GitHub\frontend2\src\app\Admin\c\user-activities\user-activities.component.spec.ts", "TypeScript", 0, 0, 18, 0, 0, 6, 24
"c:\Users\Fire and Ice\Documents\GitHub\frontend2\src\app\Admin\c\user-activities\user-activities.component.ts", "TypeScript", 0, 0, 317, 0, 65, 10, 392
"c:\Users\Fire and Ice\Documents\GitHub\frontend2\src\app\Admin\c\users\users.component.css", "CSS", 0, 0, 0, 0, 0, 1, 1
"c:\Users\Fire and Ice\Documents\GitHub\frontend2\src\app\Admin\c\users\users.component.html", "HTML", 212, 0, 0, 0, 55, 13, 280
"c:\Users\Fire and Ice\Documents\GitHub\frontend2\src\app\Admin\c\users\users.component.spec.ts", "TypeScript", 0, 0, 18, 0, 0, 6, 24
"c:\Users\Fire and Ice\Documents\GitHub\frontend2\src\app\Admin\c\users\users.component.ts", "TypeScript", 0, 0, 1103, 0, 209, 19, 1331
"c:\Users\Fire and Ice\Documents\GitHub\frontend2\src\app\Admin\guards\first-time.guard.spec.ts", "TypeScript", 0, 0, 12, 0, 0, 5, 17
"c:\Users\Fire and Ice\Documents\GitHub\frontend2\src\app\Admin\guards\first-time.guard.ts", "TypeScript", 0, 0, 35, 0, 0, 2, 37
"c:\Users\Fire and Ice\Documents\GitHub\frontend2\src\app\Admin\payloads\admin_check_email_exist_payload.ts", "TypeScript", 0, 0, 3, 0, 0, 1, 4
"c:\Users\Fire and Ice\Documents\GitHub\frontend2\src\app\Admin\payloads\change_password_payload.ts", "TypeScript", 0, 0, 6, 0, 0, 1, 7
"c:\Users\Fire and Ice\Documents\GitHub\frontend2\src\app\Admin\payloads\datatables-response.ts", "TypeScript", 0, 0, 6, 0, 0, 1, 7
"c:\Users\Fire and Ice\Documents\GitHub\frontend2\src\app\Admin\payloads\functionality_payload.ts", "TypeScript", 0, 0, 7, 0, 0, 1, 8
"c:\Users\Fire and Ice\Documents\GitHub\frontend2\src\app\Admin\payloads\logs_payload.ts", "TypeScript", 0, 0, 15, 0, 13, 2, 30
"c:\Users\Fire and Ice\Documents\GitHub\frontend2\src\app\Admin\payloads\register_actor_payload.ts", "TypeScript", 0, 0, 10, 0, 0, 1, 11
"c:\Users\Fire and Ice\Documents\GitHub\frontend2\src\app\Admin\payloads\roles_payload.ts", "TypeScript", 0, 0, 7, 0, 0, 0, 7
"c:\Users\Fire and Ice\Documents\GitHub\frontend2\src\app\Admin\payloads\user_activity_payload.ts", "TypeScript", 0, 0, 13, 0, 1, 1, 15
"c:\Users\Fire and Ice\Documents\GitHub\frontend2\src\app\Admin\payloads\user_payload.ts", "TypeScript", 0, 0, 13, 0, 0, 1, 14
"c:\Users\Fire and Ice\Documents\GitHub\frontend2\src\app\Admin\services\admin.service.spec.ts", "TypeScript", 0, 0, 12, 0, 0, 5, 17
"c:\Users\Fire and Ice\Documents\GitHub\frontend2\src\app\Admin\services\admin.service.ts", "TypeScript", 0, 0, 141, 0, 2, 24, 167
"c:\Users\Fire and Ice\Documents\GitHub\frontend2\src\app\Admin\validators\phone_number_validator.ts", "TypeScript", 0, 0, 16, 0, 6, 4, 26
"c:\Users\Fire and Ice\Documents\GitHub\frontend2\src\app\Approver\c\remark\send-account-remark\send-account-remark.component.css", "CSS", 0, 0, 0, 0, 0, 1, 1
"c:\Users\Fire and Ice\Documents\GitHub\frontend2\src\app\Approver\c\remark\send-account-remark\send-account-remark.component.html", "HTML", 106, 0, 0, 0, 0, 12, 118
"c:\Users\Fire and Ice\Documents\GitHub\frontend2\src\app\Approver\c\remark\send-account-remark\send-account-remark.component.spec.ts", "TypeScript", 0, 0, 18, 0, 0, 6, 24
"c:\Users\Fire and Ice\Documents\GitHub\frontend2\src\app\Approver\c\remark\send-account-remark\send-account-remark.component.ts", "TypeScript", 0, 0, 187, 0, 6, 17, 210
"c:\Users\Fire and Ice\Documents\GitHub\frontend2\src\app\Approver\c\remark\send-currency-remark\send-currency-remark.component.css", "CSS", 0, 0, 0, 0, 0, 1, 1
"c:\Users\Fire and Ice\Documents\GitHub\frontend2\src\app\Approver\c\remark\send-currency-remark\send-currency-remark.component.html", "HTML", 106, 0, 0, 0, 0, 7, 113
"c:\Users\Fire and Ice\Documents\GitHub\frontend2\src\app\Approver\c\remark\send-currency-remark\send-currency-remark.component.spec.ts", "TypeScript", 0, 0, 18, 0, 0, 6, 24
"c:\Users\Fire and Ice\Documents\GitHub\frontend2\src\app\Approver\c\remark\send-currency-remark\send-currency-remark.component.ts", "TypeScript", 0, 0, 187, 0, 6, 18, 211
"c:\Users\Fire and Ice\Documents\GitHub\frontend2\src\app\Approver\c\remark\view-account-remark\view-account-remark.component.css", "CSS", 0, 0, 0, 0, 0, 1, 1
"c:\Users\Fire and Ice\Documents\GitHub\frontend2\src\app\Approver\c\remark\view-account-remark\view-account-remark.component.html", "HTML", 111, 0, 0, 0, 0, 7, 118
"c:\Users\Fire and Ice\Documents\GitHub\frontend2\src\app\Approver\c\remark\view-account-remark\view-account-remark.component.spec.ts", "TypeScript", 0, 0, 18, 0, 0, 6, 24
"c:\Users\Fire and Ice\Documents\GitHub\frontend2\src\app\Approver\c\remark\view-account-remark\view-account-remark.component.ts", "TypeScript", 0, 0, 453, 0, 27, 53, 533
"c:\Users\Fire and Ice\Documents\GitHub\frontend2\src\app\Approver\c\remark\view-currency-remark\view-currency-remark.component.css", "CSS", 0, 0, 0, 0, 0, 1, 1
"c:\Users\Fire and Ice\Documents\GitHub\frontend2\src\app\Approver\c\remark\view-currency-remark\view-currency-remark.component.html", "HTML", 111, 0, 0, 0, 0, 9, 120
"c:\Users\Fire and Ice\Documents\GitHub\frontend2\src\app\Approver\c\remark\view-currency-remark\view-currency-remark.component.spec.ts", "TypeScript", 0, 0, 18, 0, 0, 6, 24
"c:\Users\Fire and Ice\Documents\GitHub\frontend2\src\app\Approver\c\remark\view-currency-remark\view-currency-remark.component.ts", "TypeScript", 0, 0, 455, 0, 25, 54, 534
"c:\Users\Fire and Ice\Documents\GitHub\frontend2\src\app\Approver\c\requests\account-requests\account-requests.component.css", "CSS", 0, 0, 0, 0, 0, 1, 1
"c:\Users\Fire and Ice\Documents\GitHub\frontend2\src\app\Approver\c\requests\account-requests\account-requests.component.html", "HTML", 111, 0, 0, 0, 0, 5, 116
"c:\Users\Fire and Ice\Documents\GitHub\frontend2\src\app\Approver\c\requests\account-requests\account-requests.component.spec.ts", "TypeScript", 0, 0, 18, 0, 0, 6, 24
"c:\Users\Fire and Ice\Documents\GitHub\frontend2\src\app\Approver\c\requests\account-requests\account-requests.component.ts", "TypeScript", 0, 0, 741, 0, 42, 56, 839
"c:\Users\Fire and Ice\Documents\GitHub\frontend2\src\app\Approver\c\requests\approved-account-requests\approved-account-requests.component.css", "CSS", 0, 0, 0, 0, 0, 1, 1
"c:\Users\Fire and Ice\Documents\GitHub\frontend2\src\app\Approver\c\requests\approved-account-requests\approved-account-requests.component.html", "HTML", 34, 0, 0, 0, 0, 4, 38
"c:\Users\Fire and Ice\Documents\GitHub\frontend2\src\app\Approver\c\requests\approved-account-requests\approved-account-requests.component.spec.ts", "TypeScript", 0, 0, 18, 0, 0, 6, 24
"c:\Users\Fire and Ice\Documents\GitHub\frontend2\src\app\Approver\c\requests\approved-account-requests\approved-account-requests.component.ts", "TypeScript", 0, 0, 305, 0, 14, 34, 353
"c:\Users\Fire and Ice\Documents\GitHub\frontend2\src\app\Approver\c\requests\approved-currency-requests\approved-currency-requests.component.css", "CSS", 0, 0, 0, 0, 0, 1, 1
"c:\Users\Fire and Ice\Documents\GitHub\frontend2\src\app\Approver\c\requests\approved-currency-requests\approved-currency-requests.component.html", "HTML", 34, 0, 0, 0, 0, 3, 37
"c:\Users\Fire and Ice\Documents\GitHub\frontend2\src\app\Approver\c\requests\approved-currency-requests\approved-currency-requests.component.spec.ts", "TypeScript", 0, 0, 18, 0, 0, 6, 24
"c:\Users\Fire and Ice\Documents\GitHub\frontend2\src\app\Approver\c\requests\approved-currency-requests\approved-currency-requests.component.ts", "TypeScript", 0, 0, 300, 0, 20, 31, 351
"c:\Users\Fire and Ice\Documents\GitHub\frontend2\src\app\Approver\c\requests\currency-requests\currency-requests.component.css", "CSS", 0, 0, 0, 0, 0, 1, 1
"c:\Users\Fire and Ice\Documents\GitHub\frontend2\src\app\Approver\c\requests\currency-requests\currency-requests.component.html", "HTML", 122, 0, 0, 0, 0, 7, 129
"c:\Users\Fire and Ice\Documents\GitHub\frontend2\src\app\Approver\c\requests\currency-requests\currency-requests.component.spec.ts", "TypeScript", 0, 0, 18, 0, 0, 6, 24
"c:\Users\Fire and Ice\Documents\GitHub\frontend2\src\app\Approver\c\requests\currency-requests\currency-requests.component.ts", "TypeScript", 0, 0, 743, 0, 41, 54, 838
"c:\Users\Fire and Ice\Documents\GitHub\frontend2\src\app\Approver\c\requests\rejected-account-requests\rejected-account-requests.component.css", "CSS", 0, 0, 0, 0, 0, 1, 1
"c:\Users\Fire and Ice\Documents\GitHub\frontend2\src\app\Approver\c\requests\rejected-account-requests\rejected-account-requests.component.html", "HTML", 34, 0, 0, 0, 0, 6, 40
"c:\Users\Fire and Ice\Documents\GitHub\frontend2\src\app\Approver\c\requests\rejected-account-requests\rejected-account-requests.component.spec.ts", "TypeScript", 0, 0, 18, 0, 0, 6, 24
"c:\Users\Fire and Ice\Documents\GitHub\frontend2\src\app\Approver\c\requests\rejected-account-requests\rejected-account-requests.component.ts", "TypeScript", 0, 0, 307, 0, 20, 32, 359
"c:\Users\Fire and Ice\Documents\GitHub\frontend2\src\app\Approver\c\requests\rejected-currency-requests\rejected-currency-requests.component.css", "CSS", 0, 0, 0, 0, 0, 1, 1
"c:\Users\Fire and Ice\Documents\GitHub\frontend2\src\app\Approver\c\requests\rejected-currency-requests\rejected-currency-requests.component.html", "HTML", 34, 0, 0, 0, 0, 4, 38
"c:\Users\Fire and Ice\Documents\GitHub\frontend2\src\app\Approver\c\requests\rejected-currency-requests\rejected-currency-requests.component.spec.ts", "TypeScript", 0, 0, 18, 0, 0, 6, 24
"c:\Users\Fire and Ice\Documents\GitHub\frontend2\src\app\Approver\c\requests\rejected-currency-requests\rejected-currency-requests.component.ts", "TypeScript", 0, 0, 302, 0, 20, 32, 354
"c:\Users\Fire and Ice\Documents\GitHub\frontend2\src\app\Approver\guard\role-approver.guard.spec.ts", "TypeScript", 0, 0, 12, 0, 0, 5, 17
"c:\Users\Fire and Ice\Documents\GitHub\frontend2\src\app\Approver\guard\role-approver.guard.ts", "TypeScript", 0, 0, 19, 0, 0, 3, 22
"c:\Users\Fire and Ice\Documents\GitHub\frontend2\src\app\Approver\payloads\account-request.spec.ts", "TypeScript", 0, 0, 6, 0, 0, 2, 8
"c:\Users\Fire and Ice\Documents\GitHub\frontend2\src\app\Approver\payloads\account-request.ts", "TypeScript", 0, 0, 13, 0, 0, 1, 14
"c:\Users\Fire and Ice\Documents\GitHub\frontend2\src\app\Approver\payloads\curency-request.spec.ts", "TypeScript", 0, 0, 6, 0, 0, 2, 8
"c:\Users\Fire and Ice\Documents\GitHub\frontend2\src\app\Approver\payloads\curency-request.ts", "TypeScript", 0, 0, 11, 0, 0, 2, 13
"c:\Users\Fire and Ice\Documents\GitHub\frontend2\src\app\Approver\payloads\remark.ts", "TypeScript", 0, 0, 7, 0, 0, 1, 8
"c:\Users\Fire and Ice\Documents\GitHub\frontend2\src\app\Approver\services\approver.service.spec.ts", "TypeScript", 0, 0, 12, 0, 0, 5, 17
"c:\Users\Fire and Ice\Documents\GitHub\frontend2\src\app\Approver\services\approver.service.ts", "TypeScript", 0, 0, 131, 0, 0, 25, 156
"c:\Users\Fire and Ice\Documents\GitHub\frontend2\src\app\Auth\guards\auth.guard.spec.ts", "TypeScript", 0, 0, 12, 0, 0, 5, 17
"c:\Users\Fire and Ice\Documents\GitHub\frontend2\src\app\Auth\guards\auth.guard.ts", "TypeScript", 0, 0, 33, 0, 0, 2, 35
"c:\Users\Fire and Ice\Documents\GitHub\frontend2\src\app\Auth\guards\login\login-auth.guard.spec.ts", "TypeScript", 0, 0, 12, 0, 0, 5, 17
"c:\Users\Fire and Ice\Documents\GitHub\frontend2\src\app\Auth\guards\login\login-auth.guard.ts", "TypeScript", 0, 0, 31, 0, 3, 2, 36
"c:\Users\Fire and Ice\Documents\GitHub\frontend2\src\app\Auth\login\login.component.css", "CSS", 0, 0, 0, 0, 0, 1, 1
"c:\Users\Fire and Ice\Documents\GitHub\frontend2\src\app\Auth\login\login.component.html", "HTML", 172, 0, 0, 0, 41, 21, 234
"c:\Users\Fire and Ice\Documents\GitHub\frontend2\src\app\Auth\login\login.component.spec.ts", "TypeScript", 0, 0, 18, 0, 0, 6, 24
"c:\Users\Fire and Ice\Documents\GitHub\frontend2\src\app\Auth\login\login.component.ts", "TypeScript", 0, 0, 559, 0, 48, 22, 629
"c:\Users\Fire and Ice\Documents\GitHub\frontend2\src\app\Auth\signup\multi-dropdown-subject\multi-dropdown-subject.component.css", "CSS", 0, 0, 0, 0, 0, 1, 1
"c:\Users\Fire and Ice\Documents\GitHub\frontend2\src\app\Auth\signup\multi-dropdown-subject\multi-dropdown-subject.component.html", "HTML", 3, 0, 0, 0, 0, 0, 3
"c:\Users\Fire and Ice\Documents\GitHub\frontend2\src\app\Auth\signup\multi-dropdown-subject\multi-dropdown-subject.component.spec.ts", "TypeScript", 0, 0, 18, 0, 0, 6, 24
"c:\Users\Fire and Ice\Documents\GitHub\frontend2\src\app\Auth\signup\multi-dropdown-subject\multi-dropdown-subject.component.ts", "TypeScript", 0, 0, 30, 0, 12, 4, 46
"c:\Users\Fire and Ice\Documents\GitHub\frontend2\src\app\Auth\signup\signup.component.css", "CSS", 0, 0, 0, 0, 0, 1, 1
"c:\Users\Fire and Ice\Documents\GitHub\frontend2\src\app\Auth\signup\signup.component.html", "HTML", 301, 0, 0, 0, 0, 18, 319
"c:\Users\Fire and Ice\Documents\GitHub\frontend2\src\app\Auth\signup\signup.component.spec.ts", "TypeScript", 0, 0, 18, 0, 0, 6, 24
"c:\Users\Fire and Ice\Documents\GitHub\frontend2\src\app\Auth\signup\signup.component.ts", "TypeScript", 0, 0, 279, 0, 56, 12, 347
"c:\Users\Fire and Ice\Documents\GitHub\frontend2\src\app\ErrorHandling\HttpErrorHandler\global-http-error-handler.interceptor.spec.ts", "TypeScript", 0, 0, 13, 0, 0, 4, 17
"c:\Users\Fire and Ice\Documents\GitHub\frontend2\src\app\ErrorHandling\HttpErrorHandler\global-http-error-handler.interceptor.ts", "TypeScript", 0, 0, 23, 0, 0, 3, 26
"c:\Users\Fire and Ice\Documents\GitHub\frontend2\src\app\ErrorHandling\custom-error-handler.service.spec.ts", "TypeScript", 0, 0, 12, 0, 0, 5, 17
"c:\Users\Fire and Ice\Documents\GitHub\frontend2\src\app\ErrorHandling\custom-error-handler.service.ts", "TypeScript", 0, 0, 16, 0, 1, 2, 19
"c:\Users\Fire and Ice\Documents\GitHub\frontend2\src\app\FixedAsset\Abebayehu\component\recon-manual-fixed-asset\recon-manual-fixed-asset.component.css", "CSS", 0, 110, 0, 0, 21, 4, 135
"c:\Users\Fire and Ice\Documents\GitHub\frontend2\src\app\FixedAsset\Abebayehu\component\recon-manual-fixed-asset\recon-manual-fixed-asset.component.html", "HTML", 223, 0, 0, 0, 3, 35, 261
"c:\Users\Fire and Ice\Documents\GitHub\frontend2\src\app\FixedAsset\Abebayehu\component\recon-manual-fixed-asset\recon-manual-fixed-asset.component.spec.ts", "TypeScript", 0, 0, 18, 0, 0, 6, 24
"c:\Users\Fire and Ice\Documents\GitHub\frontend2\src\app\FixedAsset\Abebayehu\component\recon-manual-fixed-asset\recon-manual-fixed-asset.component.ts", "TypeScript", 0, 0, 2217, 0, 29, 83, 2329
"c:\Users\Fire and Ice\Documents\GitHub\frontend2\src\app\FixedAsset\Abebayehu\models\raw-fixed-core.spec.ts", "TypeScript", 0, 0, 6, 0, 0, 2, 8
"c:\Users\Fire and Ice\Documents\GitHub\frontend2\src\app\FixedAsset\Abebayehu\models\raw-fixed-core.ts", "TypeScript", 0, 0, 18, 0, 0, 2, 20
"c:\Users\Fire and Ice\Documents\GitHub\frontend2\src\app\FixedAsset\Abebayehu\models\raw-fixed-mms.spec.ts", "TypeScript", 0, 0, 6, 0, 0, 2, 8
"c:\Users\Fire and Ice\Documents\GitHub\frontend2\src\app\FixedAsset\Abebayehu\models\raw-fixed-mms.ts", "TypeScript", 0, 0, 21, 0, 0, 2, 23
"c:\Users\Fire and Ice\Documents\GitHub\frontend2\src\app\FixedAsset\Abebayehu\service\recon-manual-fixed-asset.service.spec.ts", "TypeScript", 0, 0, 12, 0, 0, 5, 17
"c:\Users\Fire and Ice\Documents\GitHub\frontend2\src\app\FixedAsset\Abebayehu\service\recon-manual-fixed-asset.service.ts", "TypeScript", 0, 0, 59, 0, 2, 14, 75
"c:\Users\Fire and Ice\Documents\GitHub\frontend2\src\app\FixedAsset\components\recon-tabs\recon-tabs.component.css", "CSS", 0, 0, 0, 0, 0, 1, 1
"c:\Users\Fire and Ice\Documents\GitHub\frontend2\src\app\FixedAsset\components\recon-tabs\recon-tabs.component.html", "HTML", 27, 0, 0, 0, 2, 3, 32
"c:\Users\Fire and Ice\Documents\GitHub\frontend2\src\app\FixedAsset\components\recon-tabs\recon-tabs.component.spec.ts", "TypeScript", 0, 0, 22, 0, 1, 6, 29
"c:\Users\Fire and Ice\Documents\GitHub\frontend2\src\app\FixedAsset\components\recon-tabs\recon-tabs.component.ts", "TypeScript", 0, 0, 21, 0, 0, 6, 27
"c:\Users\Fire and Ice\Documents\GitHub\frontend2\src\app\FixedAsset\components\view-transaction-tabs\view-transaction-tabs.component.css", "CSS", 0, 0, 0, 0, 0, 1, 1
"c:\Users\Fire and Ice\Documents\GitHub\frontend2\src\app\FixedAsset\components\view-transaction-tabs\view-transaction-tabs.component.html", "HTML", 31, 0, 0, 0, 1, 2, 34
"c:\Users\Fire and Ice\Documents\GitHub\frontend2\src\app\FixedAsset\components\view-transaction-tabs\view-transaction-tabs.component.spec.ts", "TypeScript", 0, 0, 22, 0, 1, 6, 29
"c:\Users\Fire and Ice\Documents\GitHub\frontend2\src\app\FixedAsset\components\view-transaction-tabs\view-transaction-tabs.component.ts", "TypeScript", 0, 0, 37, 0, 0, 11, 48
"c:\Users\Fire and Ice\Documents\GitHub\frontend2\src\app\FixedAsset\ewnetie\view-fixed-asset-with-reason\view-fixed-asset-with-reason.component.css", "CSS", 0, 110, 0, 0, 21, 3, 134
"c:\Users\Fire and Ice\Documents\GitHub\frontend2\src\app\FixedAsset\ewnetie\view-fixed-asset-with-reason\view-fixed-asset-with-reason.component.html", "HTML", 286, 0, 0, 0, 9, 45, 340
"c:\Users\Fire and Ice\Documents\GitHub\frontend2\src\app\FixedAsset\ewnetie\view-fixed-asset-with-reason\view-fixed-asset-with-reason.component.spec.ts", "TypeScript", 0, 0, 18, 0, 0, 6, 24
"c:\Users\Fire and Ice\Documents\GitHub\frontend2\src\app\FixedAsset\ewnetie\view-fixed-asset-with-reason\view-fixed-asset-with-reason.component.ts", "TypeScript", 0, 0, 1390, 0, 131, 59, 1580
"c:\Users\Fire and Ice\Documents\GitHub\frontend2\src\app\FixedAsset\ewnetie\view-reason.service.spec.ts", "TypeScript", 0, 0, 12, 0, 0, 5, 17
"c:\Users\Fire and Ice\Documents\GitHub\frontend2\src\app\FixedAsset\ewnetie\view-reason.service.ts", "TypeScript", 0, 0, 16, 0, 0, 6, 22
"c:\Users\Fire and Ice\Documents\GitHub\frontend2\src\app\FixedAsset\garama\component\fixed-recon-automatic\fixed-recon-automatic.component.css", "CSS", 0, 26, 0, 0, 7, 3, 36
"c:\Users\Fire and Ice\Documents\GitHub\frontend2\src\app\FixedAsset\garama\component\fixed-recon-automatic\fixed-recon-automatic.component.html", "HTML", 232, 0, 0, 0, 12, 29, 273
"c:\Users\Fire and Ice\Documents\GitHub\frontend2\src\app\FixedAsset\garama\component\fixed-recon-automatic\fixed-recon-automatic.component.spec.ts", "TypeScript", 0, 0, 18, 0, 0, 6, 24
"c:\Users\Fire and Ice\Documents\GitHub\frontend2\src\app\FixedAsset\garama\component\fixed-recon-automatic\fixed-recon-automatic.component.ts", "TypeScript", 0, 0, 1477, 0, 225, 36, 1738
"c:\Users\Fire and Ice\Documents\GitHub\frontend2\src\app\FixedAsset\garama\component\view-fixedasset-transactions\view-fixedasset-transactions.component.css", "CSS", 0, 110, 0, 0, 21, 3, 134
"c:\Users\Fire and Ice\Documents\GitHub\frontend2\src\app\FixedAsset\garama\component\view-fixedasset-transactions\view-fixedasset-transactions.component.html", "HTML", 286, 0, 0, 0, 9, 45, 340
"c:\Users\Fire and Ice\Documents\GitHub\frontend2\src\app\FixedAsset\garama\component\view-fixedasset-transactions\view-fixedasset-transactions.component.spec.ts", "TypeScript", 0, 0, 18, 0, 0, 6, 24
"c:\Users\Fire and Ice\Documents\GitHub\frontend2\src\app\FixedAsset\garama\component\view-fixedasset-transactions\view-fixedasset-transactions.component.ts", "TypeScript", 0, 0, 1386, 0, 131, 47, 1564
"c:\Users\Fire and Ice\Documents\GitHub\frontend2\src\app\FixedAsset\garama\guards\fixed-recon-automatic.guard.spec.ts", "TypeScript", 0, 0, 12, 0, 0, 5, 17
"c:\Users\Fire and Ice\Documents\GitHub\frontend2\src\app\FixedAsset\garama\guards\fixed-recon-automatic.guard.ts", "TypeScript", 0, 0, 13, 0, 0, 3, 16
"c:\Users\Fire and Ice\Documents\GitHub\frontend2\src\app\FixedAsset\garama\payload\fixed-core-data-payload.ts", "TypeScript", 0, 0, 19, 0, 0, 1, 20
"c:\Users\Fire and Ice\Documents\GitHub\frontend2\src\app\FixedAsset\garama\payload\fixed-mms-data-payload.ts", "TypeScript", 0, 0, 25, 0, 0, 1, 26
"c:\Users\Fire and Ice\Documents\GitHub\frontend2\src\app\FixedAsset\garama\services\fixed-recon-automatic.service.spec.ts", "TypeScript", 0, 0, 12, 0, 0, 5, 17
"c:\Users\Fire and Ice\Documents\GitHub\frontend2\src\app\FixedAsset\garama\services\fixed-recon-automatic.service.ts", "TypeScript", 0, 0, 61, 0, 4, 10, 75
"c:\Users\Fire and Ice\Documents\GitHub\frontend2\src\app\FixedAsset\guards\role-fixed-asset.guard.spec.ts", "TypeScript", 0, 0, 12, 0, 0, 5, 17
"c:\Users\Fire and Ice\Documents\GitHub\frontend2\src\app\FixedAsset\guards\role-fixed-asset.guard.ts", "TypeScript", 0, 0, 17, 0, 0, 3, 20
"c:\Users\Fire and Ice\Documents\GitHub\frontend2\src\app\User\c\MMS\components\reco-stoke\reco-stoke.component.css", "CSS", 0, 0, 0, 0, 0, 1, 1
"c:\Users\Fire and Ice\Documents\GitHub\frontend2\src\app\User\c\MMS\components\reco-stoke\reco-stoke.component.html", "HTML", 1, 0, 0, 0, 0, 1, 2
"c:\Users\Fire and Ice\Documents\GitHub\frontend2\src\app\User\c\MMS\components\reco-stoke\reco-stoke.component.spec.ts", "TypeScript", 0, 0, 18, 0, 0, 6, 24
"c:\Users\Fire and Ice\Documents\GitHub\frontend2\src\app\User\c\MMS\components\reco-stoke\reco-stoke.component.ts", "TypeScript", 0, 0, 8, 0, 0, 3, 11
"c:\Users\Fire and Ice\Documents\GitHub\frontend2\src\app\User\c\MMS\components\stock-view\stock-view.component.css", "CSS", 0, 0, 0, 0, 0, 1, 1
"c:\Users\Fire and Ice\Documents\GitHub\frontend2\src\app\User\c\MMS\components\stock-view\stock-view.component.html", "HTML", 19, 0, 0, 0, 10, 4, 33
"c:\Users\Fire and Ice\Documents\GitHub\frontend2\src\app\User\c\MMS\components\stock-view\stock-view.component.spec.ts", "TypeScript", 0, 0, 18, 0, 0, 6, 24
"c:\Users\Fire and Ice\Documents\GitHub\frontend2\src\app\User\c\MMS\components\stock-view\stock-view.component.ts", "TypeScript", 0, 0, 8, 0, 0, 3, 11
"c:\Users\Fire and Ice\Documents\GitHub\frontend2\src\app\User\c\MMS\components\view-stocke-matched\view-stocke-matched.component.css", "CSS", 0, 110, 0, 0, 21, 3, 134
"c:\Users\Fire and Ice\Documents\GitHub\frontend2\src\app\User\c\MMS\components\view-stocke-matched\view-stocke-matched.component.html", "HTML", 229, 0, 0, 0, 33, 36, 298
"c:\Users\Fire and Ice\Documents\GitHub\frontend2\src\app\User\c\MMS\components\view-stocke-matched\view-stocke-matched.component.spec.ts", "TypeScript", 0, 0, 18, 0, 0, 6, 24
"c:\Users\Fire and Ice\Documents\GitHub\frontend2\src\app\User\c\MMS\components\view-stocke-matched\view-stocke-matched.component.ts", "TypeScript", 0, 0, 1261, 0, 226, 48, 1535
"c:\Users\Fire and Ice\Documents\GitHub\frontend2\src\app\User\c\MMS\services\stoke.service.spec.ts", "TypeScript", 0, 0, 12, 0, 0, 5, 17
"c:\Users\Fire and Ice\Documents\GitHub\frontend2\src\app\User\c\MMS\services\stoke.service.ts", "TypeScript", 0, 0, 7, 0, 0, 3, 10
"c:\Users\Fire and Ice\Documents\GitHub\frontend2\src\app\User\c\components\Payable\components\payable-auto\payable-auto.component.css", "CSS", 0, 26, 0, 0, 7, 3, 36
"c:\Users\Fire and Ice\Documents\GitHub\frontend2\src\app\User\c\components\Payable\components\payable-auto\payable-auto.component.html", "HTML", 136, 0, 0, 0, 36, 15, 187
"c:\Users\Fire and Ice\Documents\GitHub\frontend2\src\app\User\c\components\Payable\components\payable-auto\payable-auto.component.spec.ts", "TypeScript", 0, 0, 18, 0, 0, 6, 24
"c:\Users\Fire and Ice\Documents\GitHub\frontend2\src\app\User\c\components\Payable\components\payable-auto\payable-auto.component.ts", "TypeScript", 0, 0, 1259, 0, 183, 32, 1474
"c:\Users\Fire and Ice\Documents\GitHub\frontend2\src\app\User\c\components\Payable\components\payable-matched\payable-matched.component.css", "CSS", 0, 110, 0, 0, 21, 3, 134
"c:\Users\Fire and Ice\Documents\GitHub\frontend2\src\app\User\c\components\Payable\components\payable-matched\payable-matched.component.html", "HTML", 229, 0, 0, 0, 50, 40, 319
"c:\Users\Fire and Ice\Documents\GitHub\frontend2\src\app\User\c\components\Payable\components\payable-matched\payable-matched.component.spec.ts", "TypeScript", 0, 0, 18, 0, 0, 6, 24
"c:\Users\Fire and Ice\Documents\GitHub\frontend2\src\app\User\c\components\Payable\components\payable-matched\payable-matched.component.ts", "TypeScript", 0, 0, 1032, 0, 248, 41, 1321
"c:\Users\Fire and Ice\Documents\GitHub\frontend2\src\app\User\c\components\Payable\components\payable-reco\payable-reco.component.css", "CSS", 0, 26, 0, 0, 7, 3, 36
"c:\Users\Fire and Ice\Documents\GitHub\frontend2\src\app\User\c\components\Payable\components\payable-reco\payable-reco.component.html", "HTML", 10, 0, 0, 0, 0, 3, 13
"c:\Users\Fire and Ice\Documents\GitHub\frontend2\src\app\User\c\components\Payable\components\payable-reco\payable-reco.component.spec.ts", "TypeScript", 0, 0, 18, 0, 0, 6, 24
"c:\Users\Fire and Ice\Documents\GitHub\frontend2\src\app\User\c\components\Payable\components\payable-reco\payable-reco.component.ts", "TypeScript", 0, 0, 8, 0, 0, 3, 11
"c:\Users\Fire and Ice\Documents\GitHub\frontend2\src\app\User\c\components\Payable\components\payable-reconcile\payable-reconcile.component.css", "CSS", 0, 110, 0, 0, 21, 3, 134
"c:\Users\Fire and Ice\Documents\GitHub\frontend2\src\app\User\c\components\Payable\components\payable-reconcile\payable-reconcile.component.html", "HTML", 290, 0, 0, 0, 64, 28, 382
"c:\Users\Fire and Ice\Documents\GitHub\frontend2\src\app\User\c\components\Payable\components\payable-reconcile\payable-reconcile.component.spec.ts", "TypeScript", 0, 0, 18, 0, 0, 6, 24
"c:\Users\Fire and Ice\Documents\GitHub\frontend2\src\app\User\c\components\Payable\components\payable-reconcile\payable-reconcile.component.ts", "TypeScript", 0, 0, 1831, 0, 266, 47, 2144
"c:\Users\Fire and Ice\Documents\GitHub\frontend2\src\app\User\c\components\Payable\components\payable-unmatch\payable-unmatch.component.css", "CSS", 0, 0, 0, 0, 0, 1, 1
"c:\Users\Fire and Ice\Documents\GitHub\frontend2\src\app\User\c\components\Payable\components\payable-unmatch\payable-unmatch.component.html", "HTML", 170, 0, 0, 0, 33, 32, 235
"c:\Users\Fire and Ice\Documents\GitHub\frontend2\src\app\User\c\components\Payable\components\payable-unmatch\payable-unmatch.component.spec.ts", "TypeScript", 0, 0, 18, 0, 0, 6, 24
"c:\Users\Fire and Ice\Documents\GitHub\frontend2\src\app\User\c\components\Payable\components\payable-unmatch\payable-unmatch.component.ts", "TypeScript", 0, 0, 792, 0, 336, 35, 1163
"c:\Users\Fire and Ice\Documents\GitHub\frontend2\src\app\User\c\components\Payable\components\view-edited-payable\view-edited-payable.component.css", "CSS", 0, 10, 0, 0, 0, 0, 10
"c:\Users\Fire and Ice\Documents\GitHub\frontend2\src\app\User\c\components\Payable\components\view-edited-payable\view-edited-payable.component.html", "HTML", 47, 0, 0, 0, 1, 6, 54
"c:\Users\Fire and Ice\Documents\GitHub\frontend2\src\app\User\c\components\Payable\components\view-edited-payable\view-edited-payable.component.spec.ts", "TypeScript", 0, 0, 18, 0, 0, 6, 24
"c:\Users\Fire and Ice\Documents\GitHub\frontend2\src\app\User\c\components\Payable\components\view-edited-payable\view-edited-payable.component.ts", "TypeScript", 0, 0, 572, 0, 99, 54, 725
"c:\Users\Fire and Ice\Documents\GitHub\frontend2\src\app\User\c\components\Payable\components\view-match-with-reson-payable\view-match-with-reson-payable.component.css", "CSS", 0, 110, 0, 0, 21, 3, 134
"c:\Users\Fire and Ice\Documents\GitHub\frontend2\src\app\User\c\components\Payable\components\view-match-with-reson-payable\view-match-with-reson-payable.component.html", "HTML", 206, 0, 0, 0, 33, 30, 269
"c:\Users\Fire and Ice\Documents\GitHub\frontend2\src\app\User\c\components\Payable\components\view-match-with-reson-payable\view-match-with-reson-payable.component.spec.ts", "TypeScript", 0, 0, 18, 0, 0, 6, 24
"c:\Users\Fire and Ice\Documents\GitHub\frontend2\src\app\User\c\components\Payable\components\view-match-with-reson-payable\view-match-with-reson-payable.component.ts", "TypeScript", 0, 0, 940, 0, 207, 52, 1199
"c:\Users\Fire and Ice\Documents\GitHub\frontend2\src\app\User\c\components\Payable\components\view-payable\view-payable.component.css", "CSS", 0, 0, 0, 0, 0, 1, 1
"c:\Users\Fire and Ice\Documents\GitHub\frontend2\src\app\User\c\components\Payable\components\view-payable\view-payable.component.html", "HTML", 18, 0, 0, 0, 0, 1, 19
"c:\Users\Fire and Ice\Documents\GitHub\frontend2\src\app\User\c\components\Payable\components\view-payable\view-payable.component.spec.ts", "TypeScript", 0, 0, 18, 0, 0, 6, 24
"c:\Users\Fire and Ice\Documents\GitHub\frontend2\src\app\User\c\components\Payable\components\view-payable\view-payable.component.ts", "TypeScript", 0, 0, 8, 0, 0, 3, 11
"c:\Users\Fire and Ice\Documents\GitHub\frontend2\src\app\User\c\components\account-remark-replay\account-remark-replay.component.css", "CSS", 0, 0, 0, 0, 0, 1, 1
"c:\Users\Fire and Ice\Documents\GitHub\frontend2\src\app\User\c\components\account-remark-replay\account-remark-replay.component.html", "HTML", 105, 0, 0, 0, 2, 20, 127
"c:\Users\Fire and Ice\Documents\GitHub\frontend2\src\app\User\c\components\account-remark-replay\account-remark-replay.component.spec.ts", "TypeScript", 0, 0, 18, 0, 0, 6, 24
"c:\Users\Fire and Ice\Documents\GitHub\frontend2\src\app\User\c\components\account-remark-replay\account-remark-replay.component.ts", "TypeScript", 0, 0, 167, 0, 13, 34, 214
"c:\Users\Fire and Ice\Documents\GitHub\frontend2\src\app\User\c\components\account-rmark\account-rmark.component.css", "CSS", 0, 0, 0, 0, 0, 1, 1
"c:\Users\Fire and Ice\Documents\GitHub\frontend2\src\app\User\c\components\account-rmark\account-rmark.component.html", "HTML", 40, 0, 0, 0, 0, 3, 43
"c:\Users\Fire and Ice\Documents\GitHub\frontend2\src\app\User\c\components\account-rmark\account-rmark.component.spec.ts", "TypeScript", 0, 0, 18, 0, 0, 6, 24
"c:\Users\Fire and Ice\Documents\GitHub\frontend2\src\app\User\c\components\account-rmark\account-rmark.component.ts", "TypeScript", 0, 0, 644, 0, 127, 27, 798
"c:\Users\Fire and Ice\Documents\GitHub\frontend2\src\app\User\c\components\all-accounts\all-accounts.component.css", "CSS", 0, 0, 0, 0, 0, 1, 1
"c:\Users\Fire and Ice\Documents\GitHub\frontend2\src\app\User\c\components\all-accounts\all-accounts.component.html", "HTML", 29, 0, 0, 0, 0, 2, 31
"c:\Users\Fire and Ice\Documents\GitHub\frontend2\src\app\User\c\components\all-accounts\all-accounts.component.spec.ts", "TypeScript", 0, 0, 18, 0, 0, 6, 24
"c:\Users\Fire and Ice\Documents\GitHub\frontend2\src\app\User\c\components\all-accounts\all-accounts.component.ts", "TypeScript", 0, 0, 483, 0, 45, 40, 568
"c:\Users\Fire and Ice\Documents\GitHub\frontend2\src\app\User\c\components\all-currencies\all-currencies.component.css", "CSS", 0, 0, 0, 0, 0, 1, 1
"c:\Users\Fire and Ice\Documents\GitHub\frontend2\src\app\User\c\components\all-currencies\all-currencies.component.html", "HTML", 35, 0, 0, 0, 1, 1, 37
"c:\Users\Fire and Ice\Documents\GitHub\frontend2\src\app\User\c\components\all-currencies\all-currencies.component.spec.ts", "TypeScript", 0, 0, 18, 0, 0, 6, 24
"c:\Users\Fire and Ice\Documents\GitHub\frontend2\src\app\User\c\components\all-currencies\all-currencies.component.ts", "TypeScript", 0, 0, 525, 0, 52, 40, 617
"c:\Users\Fire and Ice\Documents\GitHub\frontend2\src\app\User\c\components\approved-accounts\approved-accounts.component.css", "CSS", 0, 0, 0, 0, 0, 1, 1
"c:\Users\Fire and Ice\Documents\GitHub\frontend2\src\app\User\c\components\approved-accounts\approved-accounts.component.html", "HTML", 35, 0, 0, 0, 4, 2, 41
"c:\Users\Fire and Ice\Documents\GitHub\frontend2\src\app\User\c\components\approved-accounts\approved-accounts.component.spec.ts", "TypeScript", 0, 0, 18, 0, 0, 6, 24
"c:\Users\Fire and Ice\Documents\GitHub\frontend2\src\app\User\c\components\approved-accounts\approved-accounts.component.ts", "TypeScript", 0, 0, 458, 0, 57, 42, 557
"c:\Users\Fire and Ice\Documents\GitHub\frontend2\src\app\User\c\components\approved-currencies\approved-currencies.component.css", "CSS", 0, 0, 0, 0, 0, 1, 1
"c:\Users\Fire and Ice\Documents\GitHub\frontend2\src\app\User\c\components\approved-currencies\approved-currencies.component.html", "HTML", 35, 0, 0, 0, 4, 1, 40
"c:\Users\Fire and Ice\Documents\GitHub\frontend2\src\app\User\c\components\approved-currencies\approved-currencies.component.spec.ts", "TypeScript", 0, 0, 18, 0, 0, 6, 24
"c:\Users\Fire and Ice\Documents\GitHub\frontend2\src\app\User\c\components\approved-currencies\approved-currencies.component.ts", "TypeScript", 0, 0, 500, 0, 67, 36, 603
"c:\Users\Fire and Ice\Documents\GitHub\frontend2\src\app\User\c\components\create-account\create-account.component.css", "CSS", 0, 0, 0, 0, 0, 1, 1
"c:\Users\Fire and Ice\Documents\GitHub\frontend2\src\app\User\c\components\create-account\create-account.component.html", "HTML", 161, 0, 0, 0, 36, 14, 211
"c:\Users\Fire and Ice\Documents\GitHub\frontend2\src\app\User\c\components\create-account\create-account.component.spec.ts", "TypeScript", 0, 0, 18, 0, 0, 6, 24
"c:\Users\Fire and Ice\Documents\GitHub\frontend2\src\app\User\c\components\create-account\create-account.component.ts", "TypeScript", 0, 0, 283, 0, 15, 20, 318
"c:\Users\Fire and Ice\Documents\GitHub\frontend2\src\app\User\c\components\create-currency\create-currency.component.css", "CSS", 0, 0, 0, 0, 0, 1, 1
"c:\Users\Fire and Ice\Documents\GitHub\frontend2\src\app\User\c\components\create-currency\create-currency.component.html", "HTML", 135, 0, 0, 0, 12, 26, 173
"c:\Users\Fire and Ice\Documents\GitHub\frontend2\src\app\User\c\components\create-currency\create-currency.component.spec.ts", "TypeScript", 0, 0, 18, 0, 0, 6, 24
"c:\Users\Fire and Ice\Documents\GitHub\frontend2\src\app\User\c\components\create-currency\create-currency.component.ts", "TypeScript", 0, 0, 178, 0, 13, 20, 211
"c:\Users\Fire and Ice\Documents\GitHub\frontend2\src\app\User\c\components\currency-edit\currency-edit.component.css", "CSS", 0, 0, 0, 0, 0, 1, 1
"c:\Users\Fire and Ice\Documents\GitHub\frontend2\src\app\User\c\components\currency-edit\currency-edit.component.html", "HTML", 146, 0, 0, 0, 1, 26, 173
"c:\Users\Fire and Ice\Documents\GitHub\frontend2\src\app\User\c\components\currency-edit\currency-edit.component.spec.ts", "TypeScript", 0, 0, 18, 0, 0, 6, 24
"c:\Users\Fire and Ice\Documents\GitHub\frontend2\src\app\User\c\components\currency-edit\currency-edit.component.ts", "TypeScript", 0, 0, 251, 0, 20, 44, 315
"c:\Users\Fire and Ice\Documents\GitHub\frontend2\src\app\User\c\components\currency-list\currency-list.component.css", "CSS", 0, 0, 0, 0, 0, 1, 1
"c:\Users\Fire and Ice\Documents\GitHub\frontend2\src\app\User\c\components\currency-list\currency-list.component.html", "HTML", 52, 0, 0, 0, 0, 8, 60
"c:\Users\Fire and Ice\Documents\GitHub\frontend2\src\app\User\c\components\currency-list\currency-list.component.spec.ts", "TypeScript", 0, 0, 18, 0, 0, 6, 24
"c:\Users\Fire and Ice\Documents\GitHub\frontend2\src\app\User\c\components\currency-list\currency-list.component.ts", "TypeScript", 0, 0, 516, 0, 239, 42, 797
"c:\Users\Fire and Ice\Documents\GitHub\frontend2\src\app\User\c\components\currency-remark-edit\currency-remark-edit.component.css", "CSS", 0, 0, 0, 0, 0, 1, 1
"c:\Users\Fire and Ice\Documents\GitHub\frontend2\src\app\User\c\components\currency-remark-edit\currency-remark-edit.component.html", "HTML", 1, 0, 0, 0, 0, 1, 2
"c:\Users\Fire and Ice\Documents\GitHub\frontend2\src\app\User\c\components\currency-remark-edit\currency-remark-edit.component.spec.ts", "TypeScript", 0, 0, 18, 0, 0, 6, 24
"c:\Users\Fire and Ice\Documents\GitHub\frontend2\src\app\User\c\components\currency-remark-edit\currency-remark-edit.component.ts", "TypeScript", 0, 0, 8, 0, 0, 3, 11
"c:\Users\Fire and Ice\Documents\GitHub\frontend2\src\app\User\c\components\edit-account-rmark\edit-account-rmark.component.css", "CSS", 0, 0, 0, 0, 0, 1, 1
"c:\Users\Fire and Ice\Documents\GitHub\frontend2\src\app\User\c\components\edit-account-rmark\edit-account-rmark.component.html", "HTML", 107, 0, 0, 0, 2, 25, 134
"c:\Users\Fire and Ice\Documents\GitHub\frontend2\src\app\User\c\components\edit-account-rmark\edit-account-rmark.component.spec.ts", "TypeScript", 0, 0, 18, 0, 0, 6, 24
"c:\Users\Fire and Ice\Documents\GitHub\frontend2\src\app\User\c\components\edit-account-rmark\edit-account-rmark.component.ts", "TypeScript", 0, 0, 251, 0, 14, 12, 277
"c:\Users\Fire and Ice\Documents\GitHub\frontend2\src\app\User\c\components\edit-account\edit-account.component.css", "CSS", 0, 0, 0, 0, 0, 1, 1
"c:\Users\Fire and Ice\Documents\GitHub\frontend2\src\app\User\c\components\edit-account\edit-account.component.html", "HTML", 165, 0, 0, 0, 12, 17, 194
"c:\Users\Fire and Ice\Documents\GitHub\frontend2\src\app\User\c\components\edit-account\edit-account.component.spec.ts", "TypeScript", 0, 0, 18, 0, 0, 6, 24
"c:\Users\Fire and Ice\Documents\GitHub\frontend2\src\app\User\c\components\edit-account\edit-account.component.ts", "TypeScript", 0, 0, 330, 0, 15, 40, 385
"c:\Users\Fire and Ice\Documents\GitHub\frontend2\src\app\User\c\components\edit-currency-remark\edit-currency-remark.component.css", "CSS", 0, 0, 0, 0, 0, 1, 1
"c:\Users\Fire and Ice\Documents\GitHub\frontend2\src\app\User\c\components\edit-currency-remark\edit-currency-remark.component.html", "HTML", 107, 0, 0, 0, 2, 25, 134
"c:\Users\Fire and Ice\Documents\GitHub\frontend2\src\app\User\c\components\edit-currency-remark\edit-currency-remark.component.spec.ts", "TypeScript", 0, 0, 18, 0, 0, 6, 24
"c:\Users\Fire and Ice\Documents\GitHub\frontend2\src\app\User\c\components\edit-currency-remark\edit-currency-remark.component.ts", "TypeScript", 0, 0, 251, 0, 12, 11, 274
"c:\Users\Fire and Ice\Documents\GitHub\frontend2\src\app\User\c\components\edit-pending-accounts\edit-pending-accounts.component.css", "CSS", 0, 0, 0, 0, 0, 1, 1
"c:\Users\Fire and Ice\Documents\GitHub\frontend2\src\app\User\c\components\edit-pending-accounts\edit-pending-accounts.component.html", "HTML", 164, 0, 0, 0, 36, 14, 214
"c:\Users\Fire and Ice\Documents\GitHub\frontend2\src\app\User\c\components\edit-pending-accounts\edit-pending-accounts.component.spec.ts", "TypeScript", 0, 0, 18, 0, 0, 6, 24
"c:\Users\Fire and Ice\Documents\GitHub\frontend2\src\app\User\c\components\edit-pending-accounts\edit-pending-accounts.component.ts", "TypeScript", 0, 0, 335, 0, 15, 16, 366
"c:\Users\Fire and Ice\Documents\GitHub\frontend2\src\app\User\c\components\edit-pending-currencies\edit-pending-currencies.component.css", "CSS", 0, 0, 0, 0, 0, 1, 1
"c:\Users\Fire and Ice\Documents\GitHub\frontend2\src\app\User\c\components\edit-pending-currencies\edit-pending-currencies.component.html", "HTML", 146, 0, 0, 0, 48, 25, 219
"c:\Users\Fire and Ice\Documents\GitHub\frontend2\src\app\User\c\components\edit-pending-currencies\edit-pending-currencies.component.spec.ts", "TypeScript", 0, 0, 18, 0, 0, 6, 24
"c:\Users\Fire and Ice\Documents\GitHub\frontend2\src\app\User\c\components\edit-pending-currencies\edit-pending-currencies.component.ts", "TypeScript", 0, 0, 247, 0, 23, 39, 309
"c:\Users\Fire and Ice\Documents\GitHub\frontend2\src\app\User\c\components\file-upload\file-upload.component.css", "CSS", 0, 0, 0, 0, 0, 1, 1
"c:\Users\Fire and Ice\Documents\GitHub\frontend2\src\app\User\c\components\file-upload\file-upload.component.html", "HTML", 222, 0, 0, 0, 9, 11, 242
"c:\Users\Fire and Ice\Documents\GitHub\frontend2\src\app\User\c\components\file-upload\file-upload.component.spec.ts", "TypeScript", 0, 0, 22, 0, 1, 6, 29
"c:\Users\Fire and Ice\Documents\GitHub\frontend2\src\app\User\c\components\file-upload\file-upload.component.ts", "TypeScript", 0, 0, 1171, 0, 194, 42, 1407
"c:\Users\Fire and Ice\Documents\GitHub\frontend2\src\app\User\c\components\issue_account\c\edited-issue-core\edited-issue-core.component.css", "CSS", 0, 10, 0, 0, 0, 0, 10
"c:\Users\Fire and Ice\Documents\GitHub\frontend2\src\app\User\c\components\issue_account\c\edited-issue-core\edited-issue-core.component.html", "HTML", 47, 0, 0, 0, 1, 6, 54
"c:\Users\Fire and Ice\Documents\GitHub\frontend2\src\app\User\c\components\issue_account\c\edited-issue-core\edited-issue-core.component.spec.ts", "TypeScript", 0, 0, 18, 0, 0, 6, 24
"c:\Users\Fire and Ice\Documents\GitHub\frontend2\src\app\User\c\components\issue_account\c\edited-issue-core\edited-issue-core.component.ts", "TypeScript", 0, 0, 573, 0, 99, 54, 726
"c:\Users\Fire and Ice\Documents\GitHub\frontend2\src\app\User\c\components\issue_account\c\edited-issue-qbs\edited-issue-qbs.component.css", "CSS", 0, 10, 0, 0, 0, 0, 10
"c:\Users\Fire and Ice\Documents\GitHub\frontend2\src\app\User\c\components\issue_account\c\edited-issue-qbs\edited-issue-qbs.component.html", "HTML", 47, 0, 0, 0, 1, 6, 54
"c:\Users\Fire and Ice\Documents\GitHub\frontend2\src\app\User\c\components\issue_account\c\edited-issue-qbs\edited-issue-qbs.component.spec.ts", "TypeScript", 0, 0, 18, 0, 0, 6, 24
"c:\Users\Fire and Ice\Documents\GitHub\frontend2\src\app\User\c\components\issue_account\c\edited-issue-qbs\edited-issue-qbs.component.ts", "TypeScript", 0, 0, 573, 0, 99, 54, 726
"c:\Users\Fire and Ice\Documents\GitHub\frontend2\src\app\User\c\components\issue_account\c\issue-core-reversal-matched\issue-core-reversal-matched.component.css", "CSS", 0, 111, 0, 0, 20, 3, 134
"c:\Users\Fire and Ice\Documents\GitHub\frontend2\src\app\User\c\components\issue_account\c\issue-core-reversal-matched\issue-core-reversal-matched.component.html", "HTML", 105, 0, 0, 0, 254, 14, 373
"c:\Users\Fire and Ice\Documents\GitHub\frontend2\src\app\User\c\components\issue_account\c\issue-core-reversal-matched\issue-core-reversal-matched.component.spec.ts", "TypeScript", 0, 0, 18, 0, 0, 6, 24
"c:\Users\Fire and Ice\Documents\GitHub\frontend2\src\app\User\c\components\issue_account\c\issue-core-reversal-matched\issue-core-reversal-matched.component.ts", "TypeScript", 0, 0, 669, 0, 227, 29, 925
"c:\Users\Fire and Ice\Documents\GitHub\frontend2\src\app\User\c\components\issue_account\c\issue-matched\issue-matched.component.css", "CSS", 0, 111, 0, 0, 20, 3, 134
"c:\Users\Fire and Ice\Documents\GitHub\frontend2\src\app\User\c\components\issue_account\c\issue-matched\issue-matched.component.html", "HTML", 197, 0, 0, 0, 151, 27, 375
"c:\Users\Fire and Ice\Documents\GitHub\frontend2\src\app\User\c\components\issue_account\c\issue-matched\issue-matched.component.spec.ts", "TypeScript", 0, 0, 18, 0, 0, 6, 24
"c:\Users\Fire and Ice\Documents\GitHub\frontend2\src\app\User\c\components\issue_account\c\issue-matched\issue-matched.component.ts", "TypeScript", 0, 0, 975, 0, 337, 51, 1363
"c:\Users\Fire and Ice\Documents\GitHub\frontend2\src\app\User\c\components\issue_account\c\issue-qbs-reversalmatched\issue-qbs-reversalmatched.component.css", "CSS", 0, 111, 0, 0, 20, 3, 134
"c:\Users\Fire and Ice\Documents\GitHub\frontend2\src\app\User\c\components\issue_account\c\issue-qbs-reversalmatched\issue-qbs-reversalmatched.component.html", "HTML", 105, 0, 0, 0, 254, 14, 373
"c:\Users\Fire and Ice\Documents\GitHub\frontend2\src\app\User\c\components\issue_account\c\issue-qbs-reversalmatched\issue-qbs-reversalmatched.component.spec.ts", "TypeScript", 0, 0, 18, 0, 0, 6, 24
"c:\Users\Fire and Ice\Documents\GitHub\frontend2\src\app\User\c\components\issue_account\c\issue-qbs-reversalmatched\issue-qbs-reversalmatched.component.ts", "TypeScript", 0, 0, 918, 0, 335, 39, 1292
"c:\Users\Fire and Ice\Documents\GitHub\frontend2\src\app\User\c\components\issue_account\c\issue-unmatched\issue-unmatched.component.css", "CSS", 0, 111, 0, 0, 20, 3, 134
"c:\Users\Fire and Ice\Documents\GitHub\frontend2\src\app\User\c\components\issue_account\c\issue-unmatched\issue-unmatched.component.html", "HTML", 134, 0, 0, 0, 151, 18, 303
"c:\Users\Fire and Ice\Documents\GitHub\frontend2\src\app\User\c\components\issue_account\c\issue-unmatched\issue-unmatched.component.spec.ts", "TypeScript", 0, 0, 18, 0, 0, 6, 24
"c:\Users\Fire and Ice\Documents\GitHub\frontend2\src\app\User\c\components\issue_account\c\issue-unmatched\issue-unmatched.component.ts", "TypeScript", 0, 0, 706, 0, 318, 31, 1055
"c:\Users\Fire and Ice\Documents\GitHub\frontend2\src\app\User\c\components\issue_account\c\matched-reason\matched-reason.component.css", "CSS", 0, 110, 0, 0, 21, 3, 134
"c:\Users\Fire and Ice\Documents\GitHub\frontend2\src\app\User\c\components\issue_account\c\matched-reason\matched-reason.component.html", "HTML", 192, 0, 0, 0, 49, 28, 269
"c:\Users\Fire and Ice\Documents\GitHub\frontend2\src\app\User\c\components\issue_account\c\matched-reason\matched-reason.component.spec.ts", "TypeScript", 0, 0, 18, 0, 0, 6, 24
"c:\Users\Fire and Ice\Documents\GitHub\frontend2\src\app\User\c\components\issue_account\c\matched-reason\matched-reason.component.ts", "TypeScript", 0, 0, 932, 0, 240, 65, 1237
"c:\Users\Fire and Ice\Documents\GitHub\frontend2\src\app\User\c\components\issue_account\c\recon-auto-issue\recon-auto-issue.component.css", "CSS", 0, 113, 0, 0, 21, 3, 137
"c:\Users\Fire and Ice\Documents\GitHub\frontend2\src\app\User\c\components\issue_account\c\recon-auto-issue\recon-auto-issue.component.html", "HTML", 135, 0, 0, 0, 0, 16, 151
"c:\Users\Fire and Ice\Documents\GitHub\frontend2\src\app\User\c\components\issue_account\c\recon-auto-issue\recon-auto-issue.component.spec.ts", "TypeScript", 0, 0, 22, 0, 1, 6, 29
"c:\Users\Fire and Ice\Documents\GitHub\frontend2\src\app\User\c\components\issue_account\c\recon-auto-issue\recon-auto-issue.component.ts", "TypeScript", 0, 0, 1653, 0, 642, 46, 2341
"c:\Users\Fire and Ice\Documents\GitHub\frontend2\src\app\User\c\components\issue_account\c\recon-manual-issue\recon-manual-issue.component.css", "CSS", 0, 114, 0, 0, 22, 2, 138
"c:\Users\Fire and Ice\Documents\GitHub\frontend2\src\app\User\c\components\issue_account\c\recon-manual-issue\recon-manual-issue.component.html", "HTML", 293, 0, 0, 0, 13, 28, 334
"c:\Users\Fire and Ice\Documents\GitHub\frontend2\src\app\User\c\components\issue_account\c\recon-manual-issue\recon-manual-issue.component.spec.ts", "TypeScript", 0, 0, 22, 0, 1, 6, 29
"c:\Users\Fire and Ice\Documents\GitHub\frontend2\src\app\User\c\components\issue_account\c\recon-manual-issue\recon-manual-issue.component.ts", "TypeScript", 0, 0, 2317, 0, 375, 51, 2743
"c:\Users\Fire and Ice\Documents\GitHub\frontend2\src\app\User\c\components\issue_account\c\reconcile-issue\reconcile-issue.component.css", "CSS", 0, 0, 0, 0, 0, 1, 1
"c:\Users\Fire and Ice\Documents\GitHub\frontend2\src\app\User\c\components\issue_account\c\reconcile-issue\reconcile-issue.component.html", "HTML", 27, 0, 0, 0, 8, 0, 35
"c:\Users\Fire and Ice\Documents\GitHub\frontend2\src\app\User\c\components\issue_account\c\reconcile-issue\reconcile-issue.component.spec.ts", "TypeScript", 0, 0, 22, 0, 1, 6, 29
"c:\Users\Fire and Ice\Documents\GitHub\frontend2\src\app\User\c\components\issue_account\c\reconcile-issue\reconcile-issue.component.ts", "TypeScript", 0, 0, 21, 0, 0, 6, 27
"c:\Users\Fire and Ice\Documents\GitHub\frontend2\src\app\User\c\components\issue_account\c\view-issue-transaction\view-issue-transaction.component.css", "CSS", 0, 0, 0, 0, 0, 1, 1
"c:\Users\Fire and Ice\Documents\GitHub\frontend2\src\app\User\c\components\issue_account\c\view-issue-transaction\view-issue-transaction.component.html", "HTML", 47, 0, 0, 0, 0, 1, 48
"c:\Users\Fire and Ice\Documents\GitHub\frontend2\src\app\User\c\components\issue_account\c\view-issue-transaction\view-issue-transaction.component.spec.ts", "TypeScript", 0, 0, 18, 0, 0, 6, 24
"c:\Users\Fire and Ice\Documents\GitHub\frontend2\src\app\User\c\components\issue_account\c\view-issue-transaction\view-issue-transaction.component.ts", "TypeScript", 0, 0, 37, 0, 0, 6, 43
"c:\Users\Fire and Ice\Documents\GitHub\frontend2\src\app\User\c\components\issue_account\guards\role-issue-account.guard.spec.ts", "TypeScript", 0, 0, 12, 0, 0, 5, 17
"c:\Users\Fire and Ice\Documents\GitHub\frontend2\src\app\User\c\components\issue_account\guards\role-issue-account.guard.ts", "TypeScript", 0, 0, 17, 0, 0, 3, 20
"c:\Users\Fire and Ice\Documents\GitHub\frontend2\src\app\User\c\components\issue_account\services\issue-account.service.spec.ts", "TypeScript", 0, 0, 12, 0, 1, 4, 17
"c:\Users\Fire and Ice\Documents\GitHub\frontend2\src\app\User\c\components\issue_account\services\issue-account.service.ts", "TypeScript", 0, 0, 169, 0, 6, 18, 193
"c:\Users\Fire and Ice\Documents\GitHub\frontend2\src\app\User\c\components\list-account\list-account.component.css", "CSS", 0, 0, 0, 0, 0, 1, 1
"c:\Users\Fire and Ice\Documents\GitHub\frontend2\src\app\User\c\components\list-account\list-account.component.html", "HTML", 45, 0, 0, 0, 1, 10, 56
"c:\Users\Fire and Ice\Documents\GitHub\frontend2\src\app\User\c\components\list-account\list-account.component.spec.ts", "TypeScript", 0, 0, 18, 0, 0, 6, 24
"c:\Users\Fire and Ice\Documents\GitHub\frontend2\src\app\User\c\components\list-account\list-account.component.ts", "TypeScript", 0, 0, 538, 0, 129, 31, 698
"c:\Users\Fire and Ice\Documents\GitHub\frontend2\src\app\User\c\components\partial-automatic\partial-automatic.component.css", "CSS", 0, 26, 0, 0, 7, 3, 36
"c:\Users\Fire and Ice\Documents\GitHub\frontend2\src\app\User\c\components\partial-automatic\partial-automatic.component.html", "HTML", 147, 0, 0, 0, 60, 15, 222
"c:\Users\Fire and Ice\Documents\GitHub\frontend2\src\app\User\c\components\partial-automatic\partial-automatic.component.spec.ts", "TypeScript", 0, 0, 18, 0, 0, 6, 24
"c:\Users\Fire and Ice\Documents\GitHub\frontend2\src\app\User\c\components\partial-automatic\partial-automatic.component.ts", "TypeScript", 0, 0, 1379, 0, 238, 32, 1649
"c:\Users\Fire and Ice\Documents\GitHub\frontend2\src\app\User\c\components\partial-matched\partial-matched.component.css", "CSS", 0, 22, 0, 0, 6, 2, 30
"c:\Users\Fire and Ice\Documents\GitHub\frontend2\src\app\User\c\components\partial-matched\partial-matched.component.html", "HTML", 143, 0, 0, 0, 61, 13, 217
"c:\Users\Fire and Ice\Documents\GitHub\frontend2\src\app\User\c\components\partial-matched\partial-matched.component.spec.ts", "TypeScript", 0, 0, 18, 0, 0, 6, 24
"c:\Users\Fire and Ice\Documents\GitHub\frontend2\src\app\User\c\components\partial-matched\partial-matched.component.ts", "TypeScript", 0, 0, 1227, 0, 1110, 41, 2378
"c:\Users\Fire and Ice\Documents\GitHub\frontend2\src\app\User\c\components\pending-accounts\pending-accounts.component.css", "CSS", 0, 0, 0, 0, 0, 1, 1
"c:\Users\Fire and Ice\Documents\GitHub\frontend2\src\app\User\c\components\pending-accounts\pending-accounts.component.html", "HTML", 35, 0, 0, 0, 4, 0, 39
"c:\Users\Fire and Ice\Documents\GitHub\frontend2\src\app\User\c\components\pending-accounts\pending-accounts.component.spec.ts", "TypeScript", 0, 0, 18, 0, 0, 6, 24
"c:\Users\Fire and Ice\Documents\GitHub\frontend2\src\app\User\c\components\pending-accounts\pending-accounts.component.ts", "TypeScript", 0, 0, 508, 0, 71, 39, 618
"c:\Users\Fire and Ice\Documents\GitHub\frontend2\src\app\User\c\components\pending-currencies\pending-currencies.component.css", "CSS", 0, 0, 0, 0, 0, 1, 1
"c:\Users\Fire and Ice\Documents\GitHub\frontend2\src\app\User\c\components\pending-currencies\pending-currencies.component.html", "HTML", 35, 0, 0, 0, 4, 0, 39
"c:\Users\Fire and Ice\Documents\GitHub\frontend2\src\app\User\c\components\pending-currencies\pending-currencies.component.spec.ts", "TypeScript", 0, 0, 18, 0, 0, 6, 24
"c:\Users\Fire and Ice\Documents\GitHub\frontend2\src\app\User\c\components\pending-currencies\pending-currencies.component.ts", "TypeScript", 0, 0, 526, 0, 63, 46, 635
"c:\Users\Fire and Ice\Documents\GitHub\frontend2\src\app\User\c\components\receivable\receivable-automatic\receivable-automatic.component.css", "CSS", 0, 26, 0, 0, 7, 3, 36
"c:\Users\Fire and Ice\Documents\GitHub\frontend2\src\app\User\c\components\receivable\receivable-automatic\receivable-automatic.component.html", "HTML", 136, 0, 0, 0, 28, 16, 180
"c:\Users\Fire and Ice\Documents\GitHub\frontend2\src\app\User\c\components\receivable\receivable-automatic\receivable-automatic.component.spec.ts", "TypeScript", 0, 0, 18, 0, 0, 6, 24
"c:\Users\Fire and Ice\Documents\GitHub\frontend2\src\app\User\c\components\receivable\receivable-automatic\receivable-automatic.component.ts", "TypeScript", 0, 0, 1253, 0, 183, 34, 1470
"c:\Users\Fire and Ice\Documents\GitHub\frontend2\src\app\User\c\components\receivable\receivable-manual\receivable-manual.component.css", "CSS", 0, 110, 0, 0, 21, 3, 134
"c:\Users\Fire and Ice\Documents\GitHub\frontend2\src\app\User\c\components\receivable\receivable-manual\receivable-manual.component.html", "HTML", 293, 0, 0, 0, 8, 30, 331
"c:\Users\Fire and Ice\Documents\GitHub\frontend2\src\app\User\c\components\receivable\receivable-manual\receivable-manual.component.spec.ts", "TypeScript", 0, 0, 18, 0, 0, 6, 24
"c:\Users\Fire and Ice\Documents\GitHub\frontend2\src\app\User\c\components\receivable\receivable-manual\receivable-manual.component.ts", "TypeScript", 0, 0, 1838, 0, 307, 53, 2198
"c:\Users\Fire and Ice\Documents\GitHub\frontend2\src\app\User\c\components\receivable\receivable-matched\receivable-matched.component.css", "CSS", 0, 110, 0, 0, 21, 3, 134
"c:\Users\Fire and Ice\Documents\GitHub\frontend2\src\app\User\c\components\receivable\receivable-matched\receivable-matched.component.html", "HTML", 229, 0, 0, 0, 50, 41, 320
"c:\Users\Fire and Ice\Documents\GitHub\frontend2\src\app\User\c\components\receivable\receivable-matched\receivable-matched.component.spec.ts", "TypeScript", 0, 0, 18, 0, 0, 6, 24
"c:\Users\Fire and Ice\Documents\GitHub\frontend2\src\app\User\c\components\receivable\receivable-matched\receivable-matched.component.ts", "TypeScript", 0, 0, 1030, 0, 248, 47, 1325
"c:\Users\Fire and Ice\Documents\GitHub\frontend2\src\app\User\c\components\receivable\receivable-unmatch\receivable-unmatch.component.css", "CSS", 0, 110, 0, 0, 21, 3, 134
"c:\Users\Fire and Ice\Documents\GitHub\frontend2\src\app\User\c\components\receivable\receivable-unmatch\receivable-unmatch.component.html", "HTML", 136, 0, 0, 0, 170, 23, 329
"c:\Users\Fire and Ice\Documents\GitHub\frontend2\src\app\User\c\components\receivable\receivable-unmatch\receivable-unmatch.component.spec.ts", "TypeScript", 0, 0, 18, 0, 0, 6, 24
"c:\Users\Fire and Ice\Documents\GitHub\frontend2\src\app\User\c\components\receivable\receivable-unmatch\receivable-unmatch.component.ts", "TypeScript", 0, 0, 1240, 0, 900, 53, 2193
"c:\Users\Fire and Ice\Documents\GitHub\frontend2\src\app\User\c\components\receivable\recon-receivable\recon-receivable.component.css", "CSS", 0, 0, 0, 0, 0, 1, 1
"c:\Users\Fire and Ice\Documents\GitHub\frontend2\src\app\User\c\components\receivable\recon-receivable\recon-receivable.component.html", "HTML", 12, 0, 0, 0, 0, 4, 16
"c:\Users\Fire and Ice\Documents\GitHub\frontend2\src\app\User\c\components\receivable\recon-receivable\recon-receivable.component.spec.ts", "TypeScript", 0, 0, 18, 0, 0, 6, 24
"c:\Users\Fire and Ice\Documents\GitHub\frontend2\src\app\User\c\components\receivable\recon-receivable\recon-receivable.component.ts", "TypeScript", 0, 0, 21, 0, 0, 6, 27
"c:\Users\Fire and Ice\Documents\GitHub\frontend2\src\app\User\c\components\receivable\recon-receivable\service\receivable-service.service.spec.ts", "TypeScript", 0, 0, 12, 0, 0, 5, 17
"c:\Users\Fire and Ice\Documents\GitHub\frontend2\src\app\User\c\components\receivable\recon-receivable\service\receivable-service.service.ts", "TypeScript", 0, 0, 108, 0, 9, 19, 136
"c:\Users\Fire and Ice\Documents\GitHub\frontend2\src\app\User\c\components\receivable\view-edited-receivable\view-edited-payable.component.css", "CSS", 0, 0, 0, 0, 0, 1, 1
"c:\Users\Fire and Ice\Documents\GitHub\frontend2\src\app\User\c\components\receivable\view-edited-receivable\view-edited-payable.component.html", "HTML", 1, 0, 0, 0, 0, 1, 2
"c:\Users\Fire and Ice\Documents\GitHub\frontend2\src\app\User\c\components\receivable\view-edited-receivable\view-edited-payable.component.spec.ts", "TypeScript", 0, 0, 18, 0, 0, 6, 24
"c:\Users\Fire and Ice\Documents\GitHub\frontend2\src\app\User\c\components\receivable\view-edited-receivable\view-edited-payable.component.ts", "TypeScript", 0, 0, 8, 0, 0, 3, 11
"c:\Users\Fire and Ice\Documents\GitHub\frontend2\src\app\User\c\components\receivable\view-match-with-reason\view-match-with-reason.component.css", "CSS", 0, 110, 0, 0, 21, 3, 134
"c:\Users\Fire and Ice\Documents\GitHub\frontend2\src\app\User\c\components\receivable\view-match-with-reason\view-match-with-reason.component.html", "HTML", 206, 0, 0, 0, 33, 30, 269
"c:\Users\Fire and Ice\Documents\GitHub\frontend2\src\app\User\c\components\receivable\view-match-with-reason\view-match-with-reason.component.spec.ts", "TypeScript", 0, 0, 18, 0, 0, 6, 24
"c:\Users\Fire and Ice\Documents\GitHub\frontend2\src\app\User\c\components\receivable\view-match-with-reason\view-match-with-reason.component.ts", "TypeScript", 0, 0, 941, 0, 207, 53, 1201
"c:\Users\Fire and Ice\Documents\GitHub\frontend2\src\app\User\c\components\receivable\view-receivable\view-receivable.component.css", "CSS", 0, 0, 0, 0, 0, 1, 1
"c:\Users\Fire and Ice\Documents\GitHub\frontend2\src\app\User\c\components\receivable\view-receivable\view-receivable.component.html", "HTML", 18, 0, 0, 0, 0, 1, 19
"c:\Users\Fire and Ice\Documents\GitHub\frontend2\src\app\User\c\components\receivable\view-receivable\view-receivable.component.spec.ts", "TypeScript", 0, 0, 18, 0, 0, 6, 24
"c:\Users\Fire and Ice\Documents\GitHub\frontend2\src\app\User\c\components\receivable\view-receivable\view-receivable.component.ts", "TypeScript", 0, 0, 8, 0, 0, 3, 11
"c:\Users\Fire and Ice\Documents\GitHub\frontend2\src\app\User\c\components\recon-automatic\recon-automatic.component.css", "CSS", 0, 26, 0, 0, 7, 3, 36
"c:\Users\Fire and Ice\Documents\GitHub\frontend2\src\app\User\c\components\recon-automatic\recon-automatic.component.html", "HTML", 154, 0, 0, 0, 52, 17, 223
"c:\Users\Fire and Ice\Documents\GitHub\frontend2\src\app\User\c\components\recon-automatic\recon-automatic.component.spec.ts", "TypeScript", 0, 0, 22, 0, 1, 6, 29
"c:\Users\Fire and Ice\Documents\GitHub\frontend2\src\app\User\c\components\recon-automatic\recon-automatic.component.ts", "TypeScript", 0, 0, 1334, 0, 228, 34, 1596
"c:\Users\Fire and Ice\Documents\GitHub\frontend2\src\app\User\c\components\recon-manual-speed\recon-manual-speed.component.css", "CSS", 0, 110, 0, 0, 21, 3, 134
"c:\Users\Fire and Ice\Documents\GitHub\frontend2\src\app\User\c\components\recon-manual-speed\recon-manual-speed.component.html", "HTML", 289, 0, 0, 0, 64, 26, 379
"c:\Users\Fire and Ice\Documents\GitHub\frontend2\src\app\User\c\components\recon-manual-speed\recon-manual-speed.component.spec.ts", "TypeScript", 0, 0, 22, 0, 1, 6, 29
"c:\Users\Fire and Ice\Documents\GitHub\frontend2\src\app\User\c\components\recon-manual-speed\recon-manual-speed.component.ts", "TypeScript", 0, 0, 4161, 0, 495, 79, 4735
"c:\Users\Fire and Ice\Documents\GitHub\frontend2\src\app\User\c\components\reconcile\recon-pas-tabs\recon-pas-tabs.component.css", "CSS", 0, 0, 0, 0, 0, 1, 1
"c:\Users\Fire and Ice\Documents\GitHub\frontend2\src\app\User\c\components\reconcile\recon-pas-tabs\recon-pas-tabs.component.html", "HTML", 20, 0, 0, 0, 29, 4, 53
"c:\Users\Fire and Ice\Documents\GitHub\frontend2\src\app\User\c\components\reconcile\recon-pas-tabs\recon-pas-tabs.component.spec.ts", "TypeScript", 0, 0, 22, 0, 1, 6, 29
"c:\Users\Fire and Ice\Documents\GitHub\frontend2\src\app\User\c\components\reconcile\recon-pas-tabs\recon-pas-tabs.component.ts", "TypeScript", 0, 0, 21, 0, 1, 5, 27
"c:\Users\Fire and Ice\Documents\GitHub\frontend2\src\app\User\c\components\reconcile\reconcile.component.css", "CSS", 0, 0, 0, 0, 0, 1, 1
"c:\Users\Fire and Ice\Documents\GitHub\frontend2\src\app\User\c\components\reconcile\reconcile.component.html", "HTML", 32, 0, 0, 0, 19, 3, 54
"c:\Users\Fire and Ice\Documents\GitHub\frontend2\src\app\User\c\components\reconcile\reconcile.component.spec.ts", "TypeScript", 0, 0, 22, 0, 1, 6, 29
"c:\Users\Fire and Ice\Documents\GitHub\frontend2\src\app\User\c\components\reconcile\reconcile.component.ts", "TypeScript", 0, 0, 21, 0, 1, 7, 29
"c:\Users\Fire and Ice\Documents\GitHub\frontend2\src\app\User\c\components\rejected-accounts\rejected-accounts.component.css", "CSS", 0, 0, 0, 0, 0, 1, 1
"c:\Users\Fire and Ice\Documents\GitHub\frontend2\src\app\User\c\components\rejected-accounts\rejected-accounts.component.html", "HTML", 35, 0, 0, 0, 4, 1, 40
"c:\Users\Fire and Ice\Documents\GitHub\frontend2\src\app\User\c\components\rejected-accounts\rejected-accounts.component.spec.ts", "TypeScript", 0, 0, 18, 0, 0, 6, 24
"c:\Users\Fire and Ice\Documents\GitHub\frontend2\src\app\User\c\components\rejected-accounts\rejected-accounts.component.ts", "TypeScript", 0, 0, 492, 0, 247, 32, 771
"c:\Users\Fire and Ice\Documents\GitHub\frontend2\src\app\User\c\components\rejected-currencies\rejected-currencies.component.css", "CSS", 0, 0, 0, 0, 0, 1, 1
"c:\Users\Fire and Ice\Documents\GitHub\frontend2\src\app\User\c\components\rejected-currencies\rejected-currencies.component.html", "HTML", 35, 0, 0, 0, 4, 0, 39
"c:\Users\Fire and Ice\Documents\GitHub\frontend2\src\app\User\c\components\rejected-currencies\rejected-currencies.component.spec.ts", "TypeScript", 0, 0, 18, 0, 0, 6, 24
"c:\Users\Fire and Ice\Documents\GitHub\frontend2\src\app\User\c\components\rejected-currencies\rejected-currencies.component.ts", "TypeScript", 0, 0, 522, 0, 64, 43, 629
"c:\Users\Fire and Ice\Documents\GitHub\frontend2\src\app\User\c\components\remark\remark.component.css", "CSS", 0, 0, 0, 0, 0, 1, 1
"c:\Users\Fire and Ice\Documents\GitHub\frontend2\src\app\User\c\components\remark\remark.component.html", "HTML", 40, 0, 0, 0, 0, 3, 43
"c:\Users\Fire and Ice\Documents\GitHub\frontend2\src\app\User\c\components\remark\remark.component.spec.ts", "TypeScript", 0, 0, 18, 0, 0, 6, 24
"c:\Users\Fire and Ice\Documents\GitHub\frontend2\src\app\User\c\components\remark\remark.component.ts", "TypeScript", 0, 0, 548, 0, 106, 55, 709
"c:\Users\Fire and Ice\Documents\GitHub\frontend2\src\app\User\c\components\replay-remark\replay-remark.component.css", "CSS", 0, 0, 0, 0, 0, 1, 1
"c:\Users\Fire and Ice\Documents\GitHub\frontend2\src\app\User\c\components\replay-remark\replay-remark.component.html", "HTML", 105, 0, 0, 0, 0, 21, 126
"c:\Users\Fire and Ice\Documents\GitHub\frontend2\src\app\User\c\components\replay-remark\replay-remark.component.spec.ts", "TypeScript", 0, 0, 18, 0, 2, 6, 26
"c:\Users\Fire and Ice\Documents\GitHub\frontend2\src\app\User\c\components\replay-remark\replay-remark.component.ts", "TypeScript", 0, 0, 160, 0, 13, 31, 204
"c:\Users\Fire and Ice\Documents\GitHub\frontend2\src\app\User\c\components\report\report-all\report-all.component.css", "CSS", 0, 0, 0, 0, 0, 1, 1
"c:\Users\Fire and Ice\Documents\GitHub\frontend2\src\app\User\c\components\report\report-all\report-all.component.html", "HTML", 73, 0, 0, 0, 0, 1, 74
"c:\Users\Fire and Ice\Documents\GitHub\frontend2\src\app\User\c\components\report\report-all\report-all.component.spec.ts", "TypeScript", 0, 0, 22, 0, 1, 6, 29
"c:\Users\Fire and Ice\Documents\GitHub\frontend2\src\app\User\c\components\report\report-all\report-all.component.ts", "TypeScript", 0, 0, 587, 0, 147, 19, 753
"c:\Users\Fire and Ice\Documents\GitHub\frontend2\src\app\User\c\components\transaction-matching-view\all-view\all-view.component.css", "CSS", 0, 0, 0, 0, 0, 1, 1
"c:\Users\Fire and Ice\Documents\GitHub\frontend2\src\app\User\c\components\transaction-matching-view\all-view\all-view.component.html", "HTML", 21, 0, 0, 0, 0, 2, 23
"c:\Users\Fire and Ice\Documents\GitHub\frontend2\src\app\User\c\components\transaction-matching-view\all-view\all-view.component.spec.ts", "TypeScript", 0, 0, 18, 0, 0, 6, 24
"c:\Users\Fire and Ice\Documents\GitHub\frontend2\src\app\User\c\components\transaction-matching-view\all-view\all-view.component.ts", "TypeScript", 0, 0, 8, 0, 0, 3, 11
"c:\Users\Fire and Ice\Documents\GitHub\frontend2\src\app\User\c\components\transaction-matching-view\btb-view\btb-view.component.css", "CSS", 0, 0, 0, 0, 0, 1, 1
"c:\Users\Fire and Ice\Documents\GitHub\frontend2\src\app\User\c\components\transaction-matching-view\btb-view\btb-view.component.html", "HTML", 19, 0, 0, 0, 10, 2, 31
"c:\Users\Fire and Ice\Documents\GitHub\frontend2\src\app\User\c\components\transaction-matching-view\btb-view\btb-view.component.spec.ts", "TypeScript", 0, 0, 18, 0, 0, 6, 24
"c:\Users\Fire and Ice\Documents\GitHub\frontend2\src\app\User\c\components\transaction-matching-view\btb-view\btb-view.component.ts", "TypeScript", 0, 0, 8, 0, 0, 3, 11
"c:\Users\Fire and Ice\Documents\GitHub\frontend2\src\app\User\c\components\transaction-matching-view\erca-view\erca-view.component.css", "CSS", 0, 0, 0, 0, 0, 1, 1
"c:\Users\Fire and Ice\Documents\GitHub\frontend2\src\app\User\c\components\transaction-matching-view\erca-view\erca-view.component.html", "HTML", 19, 0, 0, 0, 10, 3, 32
"c:\Users\Fire and Ice\Documents\GitHub\frontend2\src\app\User\c\components\transaction-matching-view\erca-view\erca-view.component.spec.ts", "TypeScript", 0, 0, 18, 0, 0, 6, 24
"c:\Users\Fire and Ice\Documents\GitHub\frontend2\src\app\User\c\components\transaction-matching-view\erca-view\erca-view.component.ts", "TypeScript", 0, 0, 8, 0, 0, 3, 11
"c:\Users\Fire and Ice\Documents\GitHub\frontend2\src\app\User\c\components\transaction-matching-view\rtgs-view\rtgs-view.component.css", "CSS", 0, 0, 0, 0, 0, 1, 1
"c:\Users\Fire and Ice\Documents\GitHub\frontend2\src\app\User\c\components\transaction-matching-view\rtgs-view\rtgs-view.component.html", "HTML", 19, 0, 0, 0, 11, 1, 31
"c:\Users\Fire and Ice\Documents\GitHub\frontend2\src\app\User\c\components\transaction-matching-view\rtgs-view\rtgs-view.component.spec.ts", "TypeScript", 0, 0, 18, 0, 0, 6, 24
"c:\Users\Fire and Ice\Documents\GitHub\frontend2\src\app\User\c\components\transaction-matching-view\rtgs-view\rtgs-view.component.ts", "TypeScript", 0, 0, 8, 0, 0, 3, 11
"c:\Users\Fire and Ice\Documents\GitHub\frontend2\src\app\User\c\components\transaction-matching-view\sos-view\sos-view.component.css", "CSS", 0, 0, 0, 0, 0, 1, 1
"c:\Users\Fire and Ice\Documents\GitHub\frontend2\src\app\User\c\components\transaction-matching-view\sos-view\sos-view.component.html", "HTML", 19, 0, 0, 0, 10, 3, 32
"c:\Users\Fire and Ice\Documents\GitHub\frontend2\src\app\User\c\components\transaction-matching-view\sos-view\sos-view.component.spec.ts", "TypeScript", 0, 0, 18, 0, 0, 6, 24
"c:\Users\Fire and Ice\Documents\GitHub\frontend2\src\app\User\c\components\transaction-matching-view\sos-view\sos-view.component.ts", "TypeScript", 0, 0, 8, 0, 0, 3, 11
"c:\Users\Fire and Ice\Documents\GitHub\frontend2\src\app\User\c\components\transaction-matching-view\view-all-matched\view-all-matched.component.css", "CSS", 0, 110, 0, 0, 21, 3, 134
"c:\Users\Fire and Ice\Documents\GitHub\frontend2\src\app\User\c\components\transaction-matching-view\view-all-matched\view-all-matched.component.html", "HTML", 228, 0, 0, 0, 33, 36, 297
"c:\Users\Fire and Ice\Documents\GitHub\frontend2\src\app\User\c\components\transaction-matching-view\view-all-matched\view-all-matched.component.spec.ts", "TypeScript", 0, 0, 18, 0, 0, 6, 24
"c:\Users\Fire and Ice\Documents\GitHub\frontend2\src\app\User\c\components\transaction-matching-view\view-all-matched\view-all-matched.component.ts", "TypeScript", 0, 0, 1062, 0, 213, 47, 1322
"c:\Users\Fire and Ice\Documents\GitHub\frontend2\src\app\User\c\components\transaction-matching-view\view-all-partially-matched\view-all-partially-matched.component.css", "CSS", 0, 110, 0, 0, 21, 3, 134
"c:\Users\Fire and Ice\Documents\GitHub\frontend2\src\app\User\c\components\transaction-matching-view\view-all-partially-matched\view-all-partially-matched.component.html", "HTML", 229, 0, 0, 0, 33, 39, 301
"c:\Users\Fire and Ice\Documents\GitHub\frontend2\src\app\User\c\components\transaction-matching-view\view-all-partially-matched\view-all-partially-matched.component.spec.ts", "TypeScript", 0, 0, 18, 0, 0, 6, 24
"c:\Users\Fire and Ice\Documents\GitHub\frontend2\src\app\User\c\components\transaction-matching-view\view-all-partially-matched\view-all-partially-matched.component.ts", "TypeScript", 0, 0, 1416, 0, 136, 38, 1590
"c:\Users\Fire and Ice\Documents\GitHub\frontend2\src\app\User\c\components\transaction-matching-view\view-all-unmatched\view-all-unmatched.component.css", "CSS", 0, 0, 0, 0, 0, 1, 1
"c:\Users\Fire and Ice\Documents\GitHub\frontend2\src\app\User\c\components\transaction-matching-view\view-all-unmatched\view-all-unmatched.component.html", "HTML", 185, 0, 0, 0, 33, 34, 252
"c:\Users\Fire and Ice\Documents\GitHub\frontend2\src\app\User\c\components\transaction-matching-view\view-all-unmatched\view-all-unmatched.component.spec.ts", "TypeScript", 0, 0, 18, 0, 0, 6, 24
"c:\Users\Fire and Ice\Documents\GitHub\frontend2\src\app\User\c\components\transaction-matching-view\view-all-unmatched\view-all-unmatched.component.ts", "TypeScript", 0, 0, 983, 0, 205, 37, 1225
"c:\Users\Fire and Ice\Documents\GitHub\frontend2\src\app\User\c\components\transaction-matching-view\view-btb-matched\view-btb-matched.component.css", "CSS", 0, 110, 0, 0, 21, 3, 134
"c:\Users\Fire and Ice\Documents\GitHub\frontend2\src\app\User\c\components\transaction-matching-view\view-btb-matched\view-btb-matched.component.html", "HTML", 229, 0, 0, 0, 33, 36, 298
"c:\Users\Fire and Ice\Documents\GitHub\frontend2\src\app\User\c\components\transaction-matching-view\view-btb-matched\view-btb-matched.component.spec.ts", "TypeScript", 0, 0, 18, 0, 0, 6, 24
"c:\Users\Fire and Ice\Documents\GitHub\frontend2\src\app\User\c\components\transaction-matching-view\view-btb-matched\view-btb-matched.component.ts", "TypeScript", 0, 0, 1346, 0, 142, 45, 1533
"c:\Users\Fire and Ice\Documents\GitHub\frontend2\src\app\User\c\components\transaction-matching-view\view-erca-matched\view-erca-matched.component.css", "CSS", 0, 110, 0, 0, 21, 3, 134
"c:\Users\Fire and Ice\Documents\GitHub\frontend2\src\app\User\c\components\transaction-matching-view\view-erca-matched\view-erca-matched.component.html", "HTML", 229, 0, 0, 0, 33, 38, 300
"c:\Users\Fire and Ice\Documents\GitHub\frontend2\src\app\User\c\components\transaction-matching-view\view-erca-matched\view-erca-matched.component.spec.ts", "TypeScript", 0, 0, 18, 0, 0, 6, 24
"c:\Users\Fire and Ice\Documents\GitHub\frontend2\src\app\User\c\components\transaction-matching-view\view-erca-matched\view-erca-matched.component.ts", "TypeScript", 0, 0, 1574, 0, 145, 42, 1761
"c:\Users\Fire and Ice\Documents\GitHub\frontend2\src\app\User\c\components\transaction-matching-view\view-rtgs-matched\view-rtgs-matched.component.css", "CSS", 0, 110, 0, 0, 21, 3, 134
"c:\Users\Fire and Ice\Documents\GitHub\frontend2\src\app\User\c\components\transaction-matching-view\view-rtgs-matched\view-rtgs-matched.component.html", "HTML", 229, 0, 0, 0, 33, 39, 301
"c:\Users\Fire and Ice\Documents\GitHub\frontend2\src\app\User\c\components\transaction-matching-view\view-rtgs-matched\view-rtgs-matched.component.spec.ts", "TypeScript", 0, 0, 18, 0, 0, 6, 24
"c:\Users\Fire and Ice\Documents\GitHub\frontend2\src\app\User\c\components\transaction-matching-view\view-rtgs-matched\view-rtgs-matched.component.ts", "TypeScript", 0, 0, 1227, 0, 117, 48, 1392
"c:\Users\Fire and Ice\Documents\GitHub\frontend2\src\app\User\c\components\transaction-matching-view\view-sos-matched\view-sos-matched.component.css", "CSS", 0, 110, 0, 0, 21, 3, 134
"c:\Users\Fire and Ice\Documents\GitHub\frontend2\src\app\User\c\components\transaction-matching-view\view-sos-matched\view-sos-matched.component.html", "HTML", 229, 0, 0, 0, 33, 35, 297
"c:\Users\Fire and Ice\Documents\GitHub\frontend2\src\app\User\c\components\transaction-matching-view\view-sos-matched\view-sos-matched.component.spec.ts", "TypeScript", 0, 0, 18, 0, 0, 6, 24
"c:\Users\Fire and Ice\Documents\GitHub\frontend2\src\app\User\c\components\transaction-matching-view\view-sos-matched\view-sos-matched.component.ts", "TypeScript", 0, 0, 1406, 0, 142, 33, 1581
"c:\Users\Fire and Ice\Documents\GitHub\frontend2\src\app\User\c\components\view-account-request\view-account-request.component.css", "CSS", 0, 6, 0, 0, 0, 1, 7
"c:\Users\Fire and Ice\Documents\GitHub\frontend2\src\app\User\c\components\view-account-request\view-account-request.component.html", "HTML", 41, 0, 0, 0, 1, 1, 43
"c:\Users\Fire and Ice\Documents\GitHub\frontend2\src\app\User\c\components\view-account-request\view-account-request.component.spec.ts", "TypeScript", 0, 0, 18, 0, 0, 6, 24
"c:\Users\Fire and Ice\Documents\GitHub\frontend2\src\app\User\c\components\view-account-request\view-account-request.component.ts", "TypeScript", 0, 0, 1301, 0, 655, 66, 2022
"c:\Users\Fire and Ice\Documents\GitHub\frontend2\src\app\User\c\components\view-currency-request\view-currency-request.component.css", "CSS", 0, 0, 0, 0, 0, 1, 1
"c:\Users\Fire and Ice\Documents\GitHub\frontend2\src\app\User\c\components\view-currency-request\view-currency-request.component.html", "HTML", 41, 0, 0, 0, 0, 1, 42
"c:\Users\Fire and Ice\Documents\GitHub\frontend2\src\app\User\c\components\view-currency-request\view-currency-request.component.spec.ts", "TypeScript", 0, 0, 18, 0, 0, 6, 24
"c:\Users\Fire and Ice\Documents\GitHub\frontend2\src\app\User\c\components\view-currency-request\view-currency-request.component.ts", "TypeScript", 0, 0, 1297, 0, 698, 59, 2054
"c:\Users\Fire and Ice\Documents\GitHub\frontend2\src\app\User\c\components\view-edited-core\view-edited-core.component.css", "CSS", 0, 10, 0, 0, 0, 0, 10
"c:\Users\Fire and Ice\Documents\GitHub\frontend2\src\app\User\c\components\view-edited-core\view-edited-core.component.html", "HTML", 47, 0, 0, 0, 1, 6, 54
"c:\Users\Fire and Ice\Documents\GitHub\frontend2\src\app\User\c\components\view-edited-core\view-edited-core.component.spec.ts", "TypeScript", 0, 0, 18, 0, 0, 6, 24
"c:\Users\Fire and Ice\Documents\GitHub\frontend2\src\app\User\c\components\view-edited-core\view-edited-core.component.ts", "TypeScript", 0, 0, 576, 0, 99, 54, 729
"c:\Users\Fire and Ice\Documents\GitHub\frontend2\src\app\User\c\components\view-edited-nbe\view-edited-nbe.component.css", "CSS", 0, 10, 0, 0, 0, 0, 10
"c:\Users\Fire and Ice\Documents\GitHub\frontend2\src\app\User\c\components\view-edited-nbe\view-edited-nbe.component.html", "HTML", 52, 0, 0, 0, 0, 7, 59
"c:\Users\Fire and Ice\Documents\GitHub\frontend2\src\app\User\c\components\view-edited-nbe\view-edited-nbe.component.spec.ts", "TypeScript", 0, 0, 18, 0, 0, 6, 24
"c:\Users\Fire and Ice\Documents\GitHub\frontend2\src\app\User\c\components\view-edited-nbe\view-edited-nbe.component.ts", "TypeScript", 0, 0, 570, 0, 85, 47, 702
"c:\Users\Fire and Ice\Documents\GitHub\frontend2\src\app\User\c\components\view-edited-transaction\view-edited-transaction.component.css", "CSS", 0, 0, 0, 0, 0, 1, 1
"c:\Users\Fire and Ice\Documents\GitHub\frontend2\src\app\User\c\components\view-edited-transaction\view-edited-transaction.component.html", "HTML", 39, 0, 0, 0, 5, 4, 48
"c:\Users\Fire and Ice\Documents\GitHub\frontend2\src\app\User\c\components\view-edited-transaction\view-edited-transaction.component.spec.ts", "TypeScript", 0, 0, 18, 0, 0, 6, 24
"c:\Users\Fire and Ice\Documents\GitHub\frontend2\src\app\User\c\components\view-edited-transaction\view-edited-transaction.component.ts", "TypeScript", 0, 0, 8, 0, 0, 3, 11
"c:\Users\Fire and Ice\Documents\GitHub\frontend2\src\app\User\c\components\view-matching-reason\view-matching-reason.component.css", "CSS", 0, 110, 0, 0, 21, 3, 134
"c:\Users\Fire and Ice\Documents\GitHub\frontend2\src\app\User\c\components\view-matching-reason\view-matching-reason.component.html", "HTML", 228, 0, 0, 0, 33, 37, 298
"c:\Users\Fire and Ice\Documents\GitHub\frontend2\src\app\User\c\components\view-matching-reason\view-matching-reason.component.spec.ts", "TypeScript", 0, 0, 18, 0, 0, 6, 24
"c:\Users\Fire and Ice\Documents\GitHub\frontend2\src\app\User\c\components\view-matching-reason\view-matching-reason.component.ts", "TypeScript", 0, 0, 894, 0, 281, 43, 1218
"c:\Users\Fire and Ice\Documents\GitHub\frontend2\src\app\User\c\components\view-transaction-history\view-transaction-history.component.css", "CSS", 0, 0, 0, 0, 0, 1, 1
"c:\Users\Fire and Ice\Documents\GitHub\frontend2\src\app\User\c\components\view-transaction-history\view-transaction-history.component.html", "HTML", 255, 0, 0, 0, 90, 77, 422
"c:\Users\Fire and Ice\Documents\GitHub\frontend2\src\app\User\c\components\view-transaction-history\view-transaction-history.component.spec.ts", "TypeScript", 0, 0, 18, 0, 0, 6, 24
"c:\Users\Fire and Ice\Documents\GitHub\frontend2\src\app\User\c\components\view-transaction-history\view-transaction-history.component.ts", "TypeScript", 0, 0, 2620, 0, 866, 106, 3592
"c:\Users\Fire and Ice\Documents\GitHub\frontend2\src\app\User\c\components\view-transacton\view-transacton.component.css", "CSS", 0, 0, 0, 0, 0, 1, 1
"c:\Users\Fire and Ice\Documents\GitHub\frontend2\src\app\User\c\components\view-transacton\view-transacton.component.html", "HTML", 59, 0, 0, 0, 0, 0, 59
"c:\Users\Fire and Ice\Documents\GitHub\frontend2\src\app\User\c\components\view-transacton\view-transacton.component.spec.ts", "TypeScript", 0, 0, 18, 0, 0, 6, 24
"c:\Users\Fire and Ice\Documents\GitHub\frontend2\src\app\User\c\components\view-transacton\view-transacton.component.ts", "TypeScript", 0, 0, 37, 0, 0, 11, 48
"c:\Users\Fire and Ice\Documents\GitHub\frontend2\src\app\User\c\guards\role-file-upload.guard.spec.ts", "TypeScript", 0, 0, 12, 0, 0, 5, 17
"c:\Users\Fire and Ice\Documents\GitHub\frontend2\src\app\User\c\guards\role-file-upload.guard.ts", "TypeScript", 0, 0, 17, 0, 0, 3, 20
"c:\Users\Fire and Ice\Documents\GitHub\frontend2\src\app\User\c\guards\role-user.guard.spec.ts", "TypeScript", 0, 0, 12, 0, 0, 5, 17
"c:\Users\Fire and Ice\Documents\GitHub\frontend2\src\app\User\c\guards\role-user.guard.ts", "TypeScript", 0, 0, 17, 0, 0, 5, 22
"c:\Users\Fire and Ice\Documents\GitHub\frontend2\src\app\User\payloads\account-payload.spec.ts", "TypeScript", 0, 0, 6, 0, 0, 2, 8
"c:\Users\Fire and Ice\Documents\GitHub\frontend2\src\app\User\payloads\account-payload.ts", "TypeScript", 0, 0, 8, 0, 0, 1, 9
"c:\Users\Fire and Ice\Documents\GitHub\frontend2\src\app\User\payloads\comment-payload.spec.ts", "TypeScript", 0, 0, 6, 0, 0, 2, 8
"c:\Users\Fire and Ice\Documents\GitHub\frontend2\src\app\User\payloads\comment-payload.ts", "TypeScript", 0, 0, 6, 0, 0, 2, 8
"c:\Users\Fire and Ice\Documents\GitHub\frontend2\src\app\User\payloads\currency-request.spec.ts", "TypeScript", 0, 0, 6, 0, 0, 2, 8
"c:\Users\Fire and Ice\Documents\GitHub\frontend2\src\app\User\payloads\currency-request.ts", "TypeScript", 0, 0, 7, 0, 0, 2, 9
"c:\Users\Fire and Ice\Documents\GitHub\frontend2\src\app\User\payloads\edit-transaction-payload\edit-transaction-payload.ts", "TypeScript", 0, 0, 10, 0, 0, 0, 10
"c:\Users\Fire and Ice\Documents\GitHub\frontend2\src\app\User\payloads\edit-transaction-payload\reason_edit_delete.ts", "TypeScript", 0, 0, 5, 0, 0, 0, 5
"c:\Users\Fire and Ice\Documents\GitHub\frontend2\src\app\User\payloads\file-payload.spec.ts", "TypeScript", 0, 0, 6, 0, 0, 2, 8
"c:\Users\Fire and Ice\Documents\GitHub\frontend2\src\app\User\payloads\file-payload.ts", "TypeScript", 0, 0, 13, 0, 0, 2, 15
"c:\Users\Fire and Ice\Documents\GitHub\frontend2\src\app\User\payloads\general-search-payload.spec.ts", "TypeScript", 0, 0, 6, 0, 0, 2, 8
"c:\Users\Fire and Ice\Documents\GitHub\frontend2\src\app\User\payloads\general-search-payload.ts", "TypeScript", 0, 0, 20, 0, 0, 5, 25
"c:\Users\Fire and Ice\Documents\GitHub\frontend2\src\app\User\payloads\match-deatail-payload-core.spec.ts", "TypeScript", 0, 0, 6, 0, 0, 2, 8
"c:\Users\Fire and Ice\Documents\GitHub\frontend2\src\app\User\payloads\match-deatail-payload-core.ts", "TypeScript", 0, 0, 12, 0, 0, 3, 15
"c:\Users\Fire and Ice\Documents\GitHub\frontend2\src\app\User\payloads\match-deatail-payload.spec.ts", "TypeScript", 0, 0, 6, 0, 0, 2, 8
"c:\Users\Fire and Ice\Documents\GitHub\frontend2\src\app\User\payloads\match-deatail-payload.ts", "TypeScript", 0, 0, 10, 0, 0, 1, 11
"c:\Users\Fire and Ice\Documents\GitHub\frontend2\src\app\User\payloads\recon\btb-ats.ts", "TypeScript", 0, 0, 38, 0, 0, 5, 43
"c:\Users\Fire and Ice\Documents\GitHub\frontend2\src\app\User\payloads\recon\btb-core.ts", "TypeScript", 0, 0, 2, 0, 0, 1, 3
"c:\Users\Fire and Ice\Documents\GitHub\frontend2\src\app\User\payloads\recon\erca-ats.ts", "TypeScript", 0, 0, 14, 0, 0, 1, 15
"c:\Users\Fire and Ice\Documents\GitHub\frontend2\src\app\User\payloads\recon\erca-core.ts", "TypeScript", 0, 0, 2, 0, 0, 1, 3
"c:\Users\Fire and Ice\Documents\GitHub\frontend2\src\app\User\payloads\recon\rtgs-ats.ts", "TypeScript", 0, 0, 29, 0, 0, 2, 31
"c:\Users\Fire and Ice\Documents\GitHub\frontend2\src\app\User\payloads\recon\rtgs-core.ts", "TypeScript", 0, 0, 23, 0, 0, 1, 24
"c:\Users\Fire and Ice\Documents\GitHub\frontend2\src\app\User\payloads\remark-payload.spec.ts", "TypeScript", 0, 0, 6, 0, 0, 2, 8
"c:\Users\Fire and Ice\Documents\GitHub\frontend2\src\app\User\payloads\remark-payload.ts", "TypeScript", 0, 0, 11, 0, 0, 3, 14
"c:\Users\Fire and Ice\Documents\GitHub\frontend2\src\app\User\payloads\replay-remark-payload.spec.ts", "TypeScript", 0, 0, 6, 0, 0, 2, 8
"c:\Users\Fire and Ice\Documents\GitHub\frontend2\src\app\User\payloads\replay-remark-payload.ts", "TypeScript", 0, 0, 6, 0, 0, 1, 7
"c:\Users\Fire and Ice\Documents\GitHub\frontend2\src\app\User\payloads\specific-search-payload.spec.ts", "TypeScript", 0, 0, 6, 0, 0, 2, 8
"c:\Users\Fire and Ice\Documents\GitHub\frontend2\src\app\User\payloads\specific-search-payload.ts", "TypeScript", 0, 0, 7, 0, 0, 3, 10
"c:\Users\Fire and Ice\Documents\GitHub\frontend2\src\app\User\payloads\total-currency-remarks.spec.ts", "TypeScript", 0, 0, 6, 0, 0, 2, 8
"c:\Users\Fire and Ice\Documents\GitHub\frontend2\src\app\User\payloads\total-currency-remarks.ts", "TypeScript", 0, 0, 3, 0, 0, 1, 4
"c:\Users\Fire and Ice\Documents\GitHub\frontend2\src\app\User\payloads\totalPayload.ts", "TypeScript", 0, 0, 3, 0, 0, 1, 4
"c:\Users\Fire and Ice\Documents\GitHub\frontend2\src\app\User\payloads\update-remark-payload.spec.ts", "TypeScript", 0, 0, 6, 0, 0, 2, 8
"c:\Users\Fire and Ice\Documents\GitHub\frontend2\src\app\User\payloads\update-remark-payload.ts", "TypeScript", 0, 0, 8, 0, 0, 2, 10
"c:\Users\Fire and Ice\Documents\GitHub\frontend2\src\app\User\services\account.service.spec.ts", "TypeScript", 0, 0, 12, 0, 0, 5, 17
"c:\Users\Fire and Ice\Documents\GitHub\frontend2\src\app\User\services\account.service.ts", "TypeScript", 0, 0, 90, 0, 9, 12, 111
"c:\Users\Fire and Ice\Documents\GitHub\frontend2\src\app\User\services\btb-recon.service.spec.ts", "TypeScript", 0, 0, 12, 0, 0, 5, 17
"c:\Users\Fire and Ice\Documents\GitHub\frontend2\src\app\User\services\btb-recon.service.ts", "TypeScript", 0, 0, 36, 0, 1, 4, 41
"c:\Users\Fire and Ice\Documents\GitHub\frontend2\src\app\User\services\currency.service.spec.ts", "TypeScript", 0, 0, 12, 0, 0, 5, 17
"c:\Users\Fire and Ice\Documents\GitHub\frontend2\src\app\User\services\currency.service.ts", "TypeScript", 0, 0, 43, 0, 9, 5, 57
"c:\Users\Fire and Ice\Documents\GitHub\frontend2\src\app\User\services\dashboard\dashboard-service.service.spec.ts", "TypeScript", 0, 0, 12, 0, 1, 4, 17
"c:\Users\Fire and Ice\Documents\GitHub\frontend2\src\app\User\services\dashboard\dashboard.service.ts", "TypeScript", 0, 0, 21, 0, 3, 8, 32
"c:\Users\Fire and Ice\Documents\GitHub\frontend2\src\app\User\services\recon-view.service.spec.ts", "TypeScript", 0, 0, 12, 0, 0, 5, 17
"c:\Users\Fire and Ice\Documents\GitHub\frontend2\src\app\User\services\recon-view.service.ts", "TypeScript", 0, 0, 163, 0, 13, 19, 195
"c:\Users\Fire and Ice\Documents\GitHub\frontend2\src\app\User\services\reconcile.service.spec.ts", "TypeScript", 0, 0, 12, 0, 1, 4, 17
"c:\Users\Fire and Ice\Documents\GitHub\frontend2\src\app\User\services\reconcile.service.ts", "TypeScript", 0, 0, 304, 0, 27, 35, 366
"c:\Users\Fire and Ice\Documents\GitHub\frontend2\src\app\User\services\remark.service.spec.ts", "TypeScript", 0, 0, 12, 0, 0, 5, 17
"c:\Users\Fire and Ice\Documents\GitHub\frontend2\src\app\User\services\remark.service.ts", "TypeScript", 0, 0, 64, 0, 4, 14, 82
"c:\Users\Fire and Ice\Documents\GitHub\frontend2\src\app\User\services\request-view.service.spec.ts", "TypeScript", 0, 0, 12, 0, 0, 5, 17
"c:\Users\Fire and Ice\Documents\GitHub\frontend2\src\app\User\services\request-view.service.ts", "TypeScript", 0, 0, 54, 0, 0, 13, 67
"c:\Users\Fire and Ice\Documents\GitHub\frontend2\src\app\User\services\transaction-history-view.service.spec.ts", "TypeScript", 0, 0, 12, 0, 0, 5, 17
"c:\Users\Fire and Ice\Documents\GitHub\frontend2\src\app\User\services\transaction-history-view.service.ts", "TypeScript", 0, 0, 51, 0, 9, 20, 80
"c:\Users\Fire and Ice\Documents\GitHub\frontend2\src\app\User\services\upload\upload.service.spec.ts", "TypeScript", 0, 0, 12, 0, 1, 4, 17
"c:\Users\Fire and Ice\Documents\GitHub\frontend2\src\app\User\services\upload\upload.service.ts", "TypeScript", 0, 0, 84, 0, 6, 10, 100
"c:\Users\Fire and Ice\Documents\GitHub\frontend2\src\app\app-routing.module.ts", "TypeScript", 0, 0, 373, 0, 23, 49, 445
"c:\Users\Fire and Ice\Documents\GitHub\frontend2\src\app\app.component.css", "CSS", 0, 15, 0, 0, 0, 2, 17
"c:\Users\Fire and Ice\Documents\GitHub\frontend2\src\app\app.component.html", "HTML", 35, 0, 0, 0, 5, 4, 44
"c:\Users\Fire and Ice\Documents\GitHub\frontend2\src\app\app.component.spec.ts", "TypeScript", 0, 0, 31, 0, 0, 5, 36
"c:\Users\Fire and Ice\Documents\GitHub\frontend2\src\app\app.component.ts", "TypeScript", 0, 0, 133, 0, 29, 10, 172
"c:\Users\Fire and Ice\Documents\GitHub\frontend2\src\app\app.module.ts", "TypeScript", 0, 0, 312, 0, 17, 34, 363
"c:\Users\Fire and Ice\Documents\GitHub\frontend2\src\app\c\components\exceptions\exceptions.component.css", "CSS", 0, 0, 0, 0, 0, 1, 1
"c:\Users\Fire and Ice\Documents\GitHub\frontend2\src\app\c\components\exceptions\exceptions.component.html", "HTML", 8, 0, 0, 0, 0, 0, 8
"c:\Users\Fire and Ice\Documents\GitHub\frontend2\src\app\c\components\exceptions\exceptions.component.spec.ts", "TypeScript", 0, 0, 18, 0, 0, 6, 24
"c:\Users\Fire and Ice\Documents\GitHub\frontend2\src\app\c\components\exceptions\exceptions.component.ts", "TypeScript", 0, 0, 8, 0, 0, 3, 11
"c:\Users\Fire and Ice\Documents\GitHub\frontend2\src\app\c\components\home\footer\footer.component.css", "CSS", 0, 0, 0, 0, 0, 1, 1
"c:\Users\Fire and Ice\Documents\GitHub\frontend2\src\app\c\components\home\footer\footer.component.html", "HTML", 13, 0, 0, 0, 4, 0, 17
"c:\Users\Fire and Ice\Documents\GitHub\frontend2\src\app\c\components\home\footer\footer.component.spec.ts", "TypeScript", 0, 0, 18, 0, 0, 6, 24
"c:\Users\Fire and Ice\Documents\GitHub\frontend2\src\app\c\components\home\footer\footer.component.ts", "TypeScript", 0, 0, 9, 0, 0, 2, 11
"c:\Users\Fire and Ice\Documents\GitHub\frontend2\src\app\c\components\home\header\header.component.css", "CSS", 0, 67, 0, 0, 5, 5, 77
"c:\Users\Fire and Ice\Documents\GitHub\frontend2\src\app\c\components\home\header\header.component.html", "HTML", 422, 0, 0, 0, 24, 49, 495
"c:\Users\Fire and Ice\Documents\GitHub\frontend2\src\app\c\components\home\header\header.component.spec.ts", "TypeScript", 0, 0, 18, 0, 0, 6, 24
"c:\Users\Fire and Ice\Documents\GitHub\frontend2\src\app\c\components\home\header\header.component.ts", "TypeScript", 0, 0, 867, 0, 126, 30, 1023
"c:\Users\Fire and Ice\Documents\GitHub\frontend2\src\app\c\components\home\home.component.css", "CSS", 0, 4, 0, 0, 0, 1, 5
"c:\Users\Fire and Ice\Documents\GitHub\frontend2\src\app\c\components\home\home.component.html", "HTML", 782, 0, 0, 0, 48, 9, 839
"c:\Users\Fire and Ice\Documents\GitHub\frontend2\src\app\c\components\home\home.component.spec.ts", "TypeScript", 0, 0, 18, 0, 0, 6, 24
"c:\Users\Fire and Ice\Documents\GitHub\frontend2\src\app\c\components\home\home.component.ts", "TypeScript", 0, 0, 1078, 0, 657, 75, 1810
"c:\Users\Fire and Ice\Documents\GitHub\frontend2\src\app\c\components\home\leftside-menu\leftside-menu.component.css", "CSS", 0, 8, 0, 0, 16, 0, 24
"c:\Users\Fire and Ice\Documents\GitHub\frontend2\src\app\c\components\home\leftside-menu\leftside-menu.component.html", "HTML", 202, 0, 0, 0, 162, 36, 400
"c:\Users\Fire and Ice\Documents\GitHub\frontend2\src\app\c\components\home\leftside-menu\leftside-menu.component.spec.ts", "TypeScript", 0, 0, 18, 0, 0, 6, 24
"c:\Users\Fire and Ice\Documents\GitHub\frontend2\src\app\c\components\home\leftside-menu\leftside-menu.component.ts", "TypeScript", 0, 0, 42, 0, 113, 15, 170
"c:\Users\Fire and Ice\Documents\GitHub\frontend2\src\app\c\components\ip-users\ip-users.component.css", "CSS", 0, 0, 0, 0, 0, 1, 1
"c:\Users\Fire and Ice\Documents\GitHub\frontend2\src\app\c\components\ip-users\ip-users.component.html", "HTML", 8, 0, 0, 0, 0, 0, 8
"c:\Users\Fire and Ice\Documents\GitHub\frontend2\src\app\c\components\ip-users\ip-users.component.spec.ts", "TypeScript", 0, 0, 18, 0, 0, 6, 24
"c:\Users\Fire and Ice\Documents\GitHub\frontend2\src\app\c\components\ip-users\ip-users.component.ts", "TypeScript", 0, 0, 8, 0, 0, 3, 11
"c:\Users\Fire and Ice\Documents\GitHub\frontend2\src\app\c\components\log-info\log-info.component.css", "CSS", 0, 0, 0, 0, 0, 1, 1
"c:\Users\Fire and Ice\Documents\GitHub\frontend2\src\app\c\components\log-info\log-info.component.html", "HTML", 8, 0, 0, 0, 0, 0, 8
"c:\Users\Fire and Ice\Documents\GitHub\frontend2\src\app\c\components\log-info\log-info.component.spec.ts", "TypeScript", 0, 0, 18, 0, 0, 6, 24
"c:\Users\Fire and Ice\Documents\GitHub\frontend2\src\app\c\components\log-info\log-info.component.ts", "TypeScript", 0, 0, 8, 0, 0, 3, 11
"c:\Users\Fire and Ice\Documents\GitHub\frontend2\src\app\c\components\navigator-upper\navigator-upper.component.css", "CSS", 0, 0, 0, 0, 0, 1, 1
"c:\Users\Fire and Ice\Documents\GitHub\frontend2\src\app\c\components\navigator-upper\navigator-upper.component.html", "HTML", 7, 0, 0, 0, 0, 2, 9
"c:\Users\Fire and Ice\Documents\GitHub\frontend2\src\app\c\components\navigator-upper\navigator-upper.component.spec.ts", "TypeScript", 0, 0, 18, 0, 0, 6, 24
"c:\Users\Fire and Ice\Documents\GitHub\frontend2\src\app\c\components\navigator-upper\navigator-upper.component.ts", "TypeScript", 0, 0, 43, 0, 2, 7, 52
"c:\Users\Fire and Ice\Documents\GitHub\frontend2\src\app\c\components\timeline\timeline.component.css", "CSS", 0, 0, 0, 0, 0, 1, 1
"c:\Users\Fire and Ice\Documents\GitHub\frontend2\src\app\c\components\timeline\timeline.component.html", "HTML", 8, 0, 0, 0, 0, 0, 8
"c:\Users\Fire and Ice\Documents\GitHub\frontend2\src\app\c\components\timeline\timeline.component.spec.ts", "TypeScript", 0, 0, 18, 0, 0, 6, 24
"c:\Users\Fire and Ice\Documents\GitHub\frontend2\src\app\c\components\timeline\timeline.component.ts", "TypeScript", 0, 0, 8, 0, 0, 3, 11
"c:\Users\Fire and Ice\Documents\GitHub\frontend2\src\app\c\guards\roles_guard\role-admin.guard.spec.ts", "TypeScript", 0, 0, 12, 0, 0, 5, 17
"c:\Users\Fire and Ice\Documents\GitHub\frontend2\src\app\c\guards\roles_guard\role-admin.guard.ts", "TypeScript", 0, 0, 29, 0, 0, 2, 31
"c:\Users\Fire and Ice\Documents\GitHub\frontend2\src\app\c\guards\roles_guard\role-student.guard.spec.ts", "TypeScript", 0, 0, 12, 0, 0, 5, 17
"c:\Users\Fire and Ice\Documents\GitHub\frontend2\src\app\c\guards\roles_guard\role-student.guard.ts", "TypeScript", 0, 0, 29, 0, 0, 2, 31
"c:\Users\Fire and Ice\Documents\GitHub\frontend2\src\app\c\guards\roles_guard\role-teacher-student.guard.spec.ts", "TypeScript", 0, 0, 12, 0, 0, 5, 17
"c:\Users\Fire and Ice\Documents\GitHub\frontend2\src\app\c\guards\roles_guard\role-teacher-student.guard.ts", "TypeScript", 0, 0, 30, 0, 0, 2, 32
"c:\Users\Fire and Ice\Documents\GitHub\frontend2\src\app\c\guards\roles_guard\role-teacher.guard.spec.ts", "TypeScript", 0, 0, 12, 0, 0, 5, 17
"c:\Users\Fire and Ice\Documents\GitHub\frontend2\src\app\c\guards\roles_guard\role-teacher.guard.ts", "TypeScript", 0, 0, 29, 0, 0, 2, 31
"c:\Users\Fire and Ice\Documents\GitHub\frontend2\src\app\c\loadScripts.ts", "TypeScript", 0, 0, 35, 0, 9, 2, 46
"c:\Users\Fire and Ice\Documents\GitHub\frontend2\src\app\landing-page\landing-page-header\landing-page-header.component.css", "CSS", 0, 0, 0, 0, 0, 1, 1
"c:\Users\Fire and Ice\Documents\GitHub\frontend2\src\app\landing-page\landing-page-header\landing-page-header.component.html", "HTML", 1, 0, 0, 0, 0, 1, 2
"c:\Users\Fire and Ice\Documents\GitHub\frontend2\src\app\landing-page\landing-page-header\landing-page-header.component.spec.ts", "TypeScript", 0, 0, 18, 0, 0, 6, 24
"c:\Users\Fire and Ice\Documents\GitHub\frontend2\src\app\landing-page\landing-page-header\landing-page-header.component.ts", "TypeScript", 0, 0, 8, 0, 0, 3, 11
"c:\Users\Fire and Ice\Documents\GitHub\frontend2\src\app\landing-page\landing-page.component.css", "CSS", 0, 0, 0, 0, 0, 1, 1
"c:\Users\Fire and Ice\Documents\GitHub\frontend2\src\app\landing-page\landing-page.component.html", "HTML", 195, 0, 0, 0, 11, 22, 228
"c:\Users\Fire and Ice\Documents\GitHub\frontend2\src\app\landing-page\landing-page.component.spec.ts", "TypeScript", 0, 0, 18, 0, 0, 6, 24
"c:\Users\Fire and Ice\Documents\GitHub\frontend2\src\app\landing-page\landing-page.component.ts", "TypeScript", 0, 0, 20, 0, 1, 3, 24
"c:\Users\Fire and Ice\Documents\GitHub\frontend2\src\app\services\auth-service.service.spec.ts", "TypeScript", 0, 0, 12, 0, 0, 5, 17
"c:\Users\Fire and Ice\Documents\GitHub\frontend2\src\app\services\auth-service.service.ts", "TypeScript", 0, 0, 247, 0, 9, 15, 271
"c:\Users\Fire and Ice\Documents\GitHub\frontend2\src\app\services\util-service\util.service.spec.ts", "TypeScript", 0, 0, 12, 0, 0, 5, 17
"c:\Users\Fire and Ice\Documents\GitHub\frontend2\src\app\services\util-service\util.service.ts", "TypeScript", 0, 0, 20, 0, 0, 3, 23
"c:\Users\Fire and Ice\Documents\GitHub\frontend2\src\app\utils_\animations.ts", "TypeScript", 0, 0, 13, 0, 11, 2, 26
"c:\Users\Fire and Ice\Documents\GitHub\frontend2\src\app\utils_\chart_js\chart-utils.min.js", "JavaScript", 0, 0, 0, 1, 1, 0, 2
"c:\Users\Fire and Ice\Documents\GitHub\frontend2\src\app\utils_\interceptors\http-client-interceptor.ts", "TypeScript", 0, 0, 36, 0, 5, 3, 44
"c:\Users\Fire and Ice\Documents\GitHub\frontend2\src\app\utils_\page-not-found\page-not-found.component.css", "CSS", 0, 0, 0, 0, 0, 1, 1
"c:\Users\Fire and Ice\Documents\GitHub\frontend2\src\app\utils_\page-not-found\page-not-found.component.html", "HTML", 23, 0, 0, 0, 13, 3, 39
"c:\Users\Fire and Ice\Documents\GitHub\frontend2\src\app\utils_\page-not-found\page-not-found.component.spec.ts", "TypeScript", 0, 0, 18, 0, 0, 6, 24
"c:\Users\Fire and Ice\Documents\GitHub\frontend2\src\app\utils_\page-not-found\page-not-found.component.ts", "TypeScript", 0, 0, 20, 0, 0, 2, 22
"c:\Users\Fire and Ice\Documents\GitHub\frontend2\src\app\utils_\payloads\Add-assignment\assignment-payload-toAdd.ts", "TypeScript", 0, 0, 7, 0, 0, 1, 8
"c:\Users\Fire and Ice\Documents\GitHub\frontend2\src\app\utils_\payloads\Auth\check-subject-payload.ts", "TypeScript", 0, 0, 3, 0, 0, 0, 3
"c:\Users\Fire and Ice\Documents\GitHub\frontend2\src\app\utils_\payloads\Auth\check-username-payload.ts", "TypeScript", 0, 0, 3, 0, 0, 0, 3
"c:\Users\Fire and Ice\Documents\GitHub\frontend2\src\app\utils_\payloads\Auth\jwt-aut-response-payload.ts", "TypeScript", 0, 0, 12, 0, 0, 0, 12
"c:\Users\Fire and Ice\Documents\GitHub\frontend2\src\app\utils_\payloads\Auth\login-payload.ts", "TypeScript", 0, 0, 7, 0, 0, 1, 8
"c:\Users\Fire and Ice\Documents\GitHub\frontend2\src\app\utils_\payloads\Auth\logout-payload.ts", "TypeScript", 0, 0, 4, 0, 0, 1, 5
"c:\Users\Fire and Ice\Documents\GitHub\frontend2\src\app\utils_\payloads\Auth\register-payload.ts", "TypeScript", 0, 0, 11, 0, 0, 0, 11
"c:\Users\Fire and Ice\Documents\GitHub\frontend2\src\app\utils_\payloads\Auth\subjects.payload.ts", "TypeScript", 0, 0, 5, 0, 0, 0, 5
"c:\Users\Fire and Ice\Documents\GitHub\frontend2\src\app\utils_\terms-and-conditions\terms-and-conditions.component.css", "CSS", 0, 0, 0, 0, 0, 1, 1
"c:\Users\Fire and Ice\Documents\GitHub\frontend2\src\app\utils_\terms-and-conditions\terms-and-conditions.component.html", "HTML", 279, 0, 0, 0, 0, 13, 292
"c:\Users\Fire and Ice\Documents\GitHub\frontend2\src\app\utils_\terms-and-conditions\terms-and-conditions.component.spec.ts", "TypeScript", 0, 0, 18, 0, 0, 6, 24
"c:\Users\Fire and Ice\Documents\GitHub\frontend2\src\app\utils_\terms-and-conditions\terms-and-conditions.component.ts", "TypeScript", 0, 0, 8, 0, 0, 3, 11
"c:\Users\Fire and Ice\Documents\GitHub\frontend2\src\app\utils_\utils.ts", "TypeScript", 0, 0, 0, 0, 70, 5, 75
"c:\Users\Fire and Ice\Documents\GitHub\frontend2\src\app\utils_\validators\cd_cr_validator.ts", "TypeScript", 0, 0, 16, 0, 0, 2, 18
"c:\Users\Fire and Ice\Documents\GitHub\frontend2\src\app\utils_\validators\greater_than_0_validator.ts", "TypeScript", 0, 0, 15, 0, 0, 2, 17
"c:\Users\Fire and Ice\Documents\GitHub\frontend2\src\app\utils_\validators\password_match_validator.ts", "TypeScript", 0, 0, 16, 0, 1, 2, 19
"c:\Users\Fire and Ice\Documents\GitHub\frontend2\src\app\utils_\validators\validator_password_strength.ts", "TypeScript", 0, 0, 13, 0, 7, 7, 27
"Total", "-", 14139, 3199, 82850, 1, 20218, 6947, 127354